acta,codigo,maduro,edmundo,otros,total_validos,total_nulo,total_invalido
017911_018022_0093Acta0093.jpg,040202001.01.1.0001,114,357,11,482,1,1
017911_032908_0032Acta0032.jpg,040201009.03.1.0001,66,344,7,417,0,0
017911_067116_0179Acta0179.jpg,040201005.03.1.0001,96,377,15,488,0,0
017911_134738_0107Acta0107.jpg,040201005.02.1.0001,102,390,14,506,0,0
017911_139267_0057Acta0057.jpg,040202010.04.1.0001,164,347,23,534,0,0
017911_325825_0082Acta0082.jpg,040201011.03.1.0001,123,465,20,608,0,0
017911_408665_0168Acta0168.jpg,040202009.05.1.0001,138,480,22,640,0,0
017911_411693_0092Acta0092.jpg,040202001.02.1.0001,140,359,18,517,0,0
017911_429661_0100Acta0100.jpg,040201008.01.1.0001,115,378,9,502,0,0
017911_459647_0094Acta0094.jpg,040202014.02.1.0001,142,392,21,555,0,0
017911_621544_0102Acta0102.jpg,040201008.05.1.0001,82,443,7,532,0,0
017911_672304_0097Acta0097.jpg,040202014.01.1.0001,133,363,27,523,0,0
017911_673882_0103Acta0103.jpg,040201008.02.1.0001,131,374,11,516,0,0
017911_693390_0127Acta0127.jpg,040203001.02.1.0001,195,387,21,603,0,0
017911_715131_0167Acta0167.jpg,040202009.04.1.0001,147,430,18,595,0,0
017911_926621_0138Acta0138.jpg,040202003.01.1.0001,104,352,18,474,0,0
017911_928009_0101Acta0101.jpg,040201008.04.1.0001,79,370,5,454,0,0
017911_986858_0037Acta0037.jpg,040201006.02.1.0001,82,373,12,467,0,0
017911_991891_0108Acta0108.jpg,040201005.04.1.0001,108,376,15,499,1,1
017911_995181_0129Acta0129.jpg,040203003.02.1.0001,143,345,14,502,0,0
018527_087743_0548Acta0453.jpg,061101009.01.1.0001,141,139,7,287,0,0
018527_498716_0433Acta0338.jpg,060401023.02.1.0001,110,280,20,410,0,0
018527_603795_0516Acta0421.jpg,060401020.01.1.0001,78,461,11,550,0,0
018527_665883_0514Acta0419.jpg,060401020.03.1.0001,84,449,13,546,0,0
018527_699504_0471Acta0376.jpg,060401029.01.1.0001,102,223,20,345,0,0
018527_716467_0529Acta0434.jpg,060401007.05.1.0001,111,528,14,653,0,0
018527_798640_0535Acta0440.jpg,061101001.01.1.0001,199,361,4,564,0,0
018527_860224_0411Acta0316.jpg,060401016.02.1.0001,101,352,16,469,0,0
018527_918177_0527Acta0432.jpg,060401007.03.1.0001,89,456,23,568,0,0
018527_939160_0449Acta0354.jpg,060401043.01.1.0001,170,108,11,289,0,0
020778_188855_0067Acta0067.jpg,041401008.01.1.0001,30,97,6,133,0,0
020778_951290_0074Acta0074.jpg,041401002.02.1.0001,48,510,9,567,0,0
021223_012659_0671Acta0169.jpg,200201022.01.1.0001,44,106,5,155,0,0
021223_013929_0232Acta0075.jpg,200401008.02.1.0001,62,364,9,435,0,0
021223_051694_0185Acta0063.jpg,201101037.01.1.0001,257,384,20,661,0,0
021223_060640_0753Acta0185.jpg,200701008.02.1.0001,91,227,6,324,0,0
021223_078367_0322Acta0094.jpg,200501001.01.1.0001,56,285,9,350,0,0
021223_146047_0508Acta0134.jpg,201301021.01.1.0001,61,30,1,92,0,0
021223_155232_0258Acta0081.jpg,200401001.02.1.0001,84,304,7,395,0,0
021223_224310_0100Acta0032.jpg,201101018.02.1.0001,208,389,25,622,0,0
021223_229522_0177Acta0060.jpg,201001018.02.1.0001,149,532,17,698,0,0
021223_389732_0170Acta0057.jpg,201101007.02.1.0001,133,437,11,581,0,0
021223_394585_0162Acta0054.jpg,201101006.03.1.0001,145,396,15,556,0,0
021223_397797_0158Acta0053.jpg,201101027.02.1.0001,120,375,13,508,0,0
021223_464207_0304Acta0090.jpg,200901008.01.1.0001,194,408,15,617,1,1
021223_513274_0369Acta0104.jpg,200101034.01.1.0001,76,109,4,189,0,0
021223_535757_0190Acta0065.jpg,201001020.01.1.0001,134,227,12,373,0,0
021223_539720_0105Acta0034.jpg,201101019.01.1.0001,227,155,11,393,0,0
021223_569807_0629Acta0160.jpg,200201002.02.1.0001,114,426,8,548,0,0
021223_571600_0565Acta0146.jpg,200801014.01.1.0001,278,267,18,563,0,0
021223_591776_0272Acta0083.jpg,200401041.01.1.0001,88,166,5,259,0,0
021223_673645_0174Acta0058.jpg,201101011.01.1.0001,141,311,11,463,0,0
021223_678753_0204Acta0068.jpg,201001009.01.1.0001,186,299,11,496,0,0
021223_737205_0690Acta0172.jpg,200201019.02.1.0001,167,213,11,391,0,0
021223_738457_0376Acta0105.jpg,200101001.02.1.0001,173,406,11,590,0,0
021223_766524_0410Acta0112.jpg,200101012.01.1.0001,107,30,7,144,0,0
021223_881853_0160Acta0054.jpg,201101006.01.1.0001,131,402,10,543,0,0
021223_901232_0151Acta0051.jpg,201001007.02.1.0001,86,272,10,368,0,0
021223_916901_0225Acta0074.jpg,200403012.01.1.0001,137,176,14,327,0,0
021223_940167_0375Acta0105.jpg,200101001.01.1.0001,224,400,13,637,0,0
021257_061791_0040Acta0040.jpg,041501001.03.1.0001,215,328,15,558,0,0
021257_097217_0074Acta0074.jpg,040401016.01.1.0001,139,220,12,371,0,0
021257_187010_0140Acta0140.jpg,040501001.02.1.0001,185,338,26,549,0,0
021257_279017_0106Acta0106.jpg,040701005.01.1.0001,123,112,7,242,0,0
021257_354120_0143Acta0143.jpg,040501001.03.1.0001,189,326,31,546,0,0
021257_387329_0141Acta0141.jpg,040501001.01.1.0001,195,327,28,550,0,0
021257_681820_0118Acta0118.jpg,040701002.01.1.0001,202,420,19,641,0,0
021258_210004_0030Acta0030.jpg,200601002.01.1.0001,200,324,11,535,0,0
021258_215133_0023Acta0023.jpg,200601013.02.1.0001,196,185,5,386,0,0
021274_243351_2024-07-29-0003.jpg,010116003.03.1.0001,216,379,31,626,0,0
021274_755398_2024-07-29-0001.jpg,010112001.01.1.0001,204,357,25,586,0,0
021274_881505_2024-07-29-0002.jpg,010118032.01.1.0001,83,374,17,474,1,1
021274_974253_2024-07-29-0003.jpg,010112019.02.1.0001,82,272,8,362,0,0
033257_002043_0225Acta0217.jpg,010122018.03.1.0001,205,377,29,611,1,1
033257_007300_0055Acta0047.jpg,010115009.05.1.0001,35,377,6,418,0,0
033257_008979_0169Acta0161.jpg,010107021.01.1.0001,171,388,23,582,0,0
033257_031873_0121Acta0113.jpg,010107028.04.1.0001,136,335,17,488,0,0
033257_033746_0160Acta0152.jpg,010107020.01.1.0001,113,294,14,421,0,0
033257_079095_0208Acta0200.jpg,010107017.03.1.0001,130,329,18,477,0,0
033257_096695_0114Acta0106.jpg,010107005.01.1.0001,238,286,24,548,0,0
033257_153799_0052Acta0044.jpg,010115009.08.1.0001,41,346,5,392,0,0
033257_191627_0226Acta0218.jpg,010122014.01.1.0001,145,327,5,477,0,0
033257_192894_0029Acta0021.jpg,010109004.06.1.0001,132,320,14,466,0,0
033257_209256_0172Acta0164.jpg,010107021.03.1.0001,174,396,16,586,0,0
033257_228977_0285Acta0277.jpg,010122047.01.1.0001,157,251,17,425,1,1
033257_252113_0151Acta0143.jpg,010107037.03.1.0001,133,224,15,372,0,0
033257_305939_0251Acta0243.jpg,010122019.01.1.0001,193,412,27,632,0,0
033257_306015_0308Acta0300.jpg,010122001.01.1.0001,135,295,21,451,0,0
033257_344462_0016Acta0010.jpg,010109002.01.1.0001,97,276,17,390,0,0
033257_365524_0084Acta0076.jpg,010115012.01.1.0001,126,374,19,519,0,0
033257_435691_0231Acta0223.jpg,010122036.01.1.0001,194,349,26,569,0,0
033257_480851_0152Acta0144.jpg,010107008.01.1.0001,249,314,23,586,0,0
033257_573834_0109Acta0101.jpg,010107013.01.1.0001,99,298,17,414,0,0
033257_589844_0290Acta0282.jpg,010122011.03.1.0001,76,341,11,428,0,0
033257_679768_0070Acta0062.jpg,010115011.03.1.0001,52,348,9,409,0,0
033257_683129_0242Acta0234.jpg,010122015.01.1.0001,101,259,20,380,0,0
033257_696202_0331Acta0323.jpg,010115007.02.1.0001,161,384,14,559,0,0
033257_725151_0074Acta0066.jpg,010115015.02.1.0001,60,386,11,457,0,0
033257_742494_0298Acta0290.jpg,010122027.02.1.0001,58,311,6,375,0,0
033257_756439_0327Acta0319.jpg,010115005.02.1.0001,228,352,21,601,0,0
033257_766657_0161Acta0153.jpg,010107020.02.1.0001,111,276,11,398,0,0
033257_811585_0307Acta0299.jpg,010122001.02.1.0001,134,314,19,467,0,0
033257_845729_0131Acta0123.jpg,010107017.04.1.0001,130,334,16,480,0,0
033257_877431_0213Acta0205.jpg,010122043.04.1.0001,61,316,5,382,0,0
033257_895818_0048Acta0040.jpg,010115010.02.1.0001,205,311,17,533,0,0
033257_905164_0304Acta0296.jpg,010122007.02.1.0001,53,250,8,311,0,0
033257_918408_0344Acta0336.jpg,010115004.01.1.0001,214,386,17,617,0,0
033257_930838_0024Acta0016.jpg,010109004.02.1.0001,153,315,16,484,1,1
033257_945843_0302Acta0294.jpg,010122011.02.1.0001,74,351,14,439,0,0
035927_076891_0135Acta0083.jpg,140502002.02.1.0001,246,293,17,556,2,2
035927_088952_0096Acta0044.jpg,140501003.03.1.0001,189,313,18,520,0,0
035927_230537_0152Acta0100.jpg,141201006.01.1.0001,177,146,8,331,0,0
035927_380555_0078Acta0026.jpg,140501001.02.1.0001,237,323,15,575,0,0
035927_423636_0208Acta0156.jpg,140401003.04.1.0001,235,333,6,574,0,0
035927_501986_0115Acta0063.jpg,140501008.02.1.0001,174,313,14,501,0,0
035927_677455_0205Acta0153.jpg,140401003.02.1.0001,223,314,10,547,0,0
035927_773007_0197Acta0145.jpg,140401004.02.1.0001,213,338,18,569,0,0
035927_934848_0150Acta0098.jpg,141201004.01.1.0001,221,284,5,510,0,0
041989_006231_0101Acta0100.jpg,070102009.01.1.0001,19,66,1,86,0,0
041989_016496_0014Acta0013.jpg,070501003.01.1.0001,201,422,14,637,0,0
041989_395251_0060Acta0059.jpg,070101002.03.1.0001,133,389,11,533,0,0
041989_455234_0061Acta0060.jpg,070101002.04.1.0001,144,434,13,591,0,0
041989_515467_0044Acta0043.jpg,070501002.03.1.0001,143,378,15,536,0,0
041989_576235_0069Acta0068.jpg,070101003.01.1.0001,144,408,10,562,0,0
041989_731265_0029Acta0028.jpg,070501013.01.1.0001,96,219,12,327,0,0
041989_806558_0053Acta0052.jpg,071001013.02.1.0001,94,249,8,351,0,0
041989_935456_0024Acta0023.jpg,070501015.01.1.0001,147,241,10,398,0,0
041989_964210_0018Acta0017.jpg,071001001.01.1.0001,99,387,9,495,0,0
060551_511357_2024-07-29-0001.jpg,200301054.01.1.0001,110,56,7,173,0,0
060551_863307_2024-07-29-0001.jpg,200301006.02.1.0001,200,415,17,632,0,0
060551_917944_2024-07-29-0001.jpg,200301013.02.1.0001,225,360,10,595,0,0
151515_346311_2024-07-29-0002.jpg,130302005.02.1.0001,148,316,25,489,0,0
25384_035823_0225Acta0225.jpg,090702007.01.1.0001,75,57,3,135,0,0
25384_066872_0237Acta0237.jpg,090704002.01.1.0001,99,161,7,267,0,0
25384_218923_0191Acta0191.jpg,090707003.01.1.0001,138,120,13,271,0,0
25384_383813_0189Acta0189.jpg,090706009.01.1.0001,187,383,12,582,0,0
25384_662478_0228Acta0228.jpg,090701016.01.1.0001,102,122,4,228,0,0
25384_792846_0202Acta0202.jpg,090706009.02.1.0001,191,356,12,559,0,0
25384_798519_0181Acta0181.jpg,090705004.01.1.0001,114,168,1,283,0,0
25384_965507_0162Acta0162.jpg,090703003.01.1.0001,44,81,7,132,0,0
25384_989931_0213Acta0213.jpg,090702004.01.1.0001,70,97,5,172,0,0
388421_018293_0346Acta0129.jpg,030604002.01.1.0001,89,53,0,142,0,0
388421_030039_0253Acta0095.jpg,030603003.04.1.0001,199,295,13,507,0,0
388421_060476_0349Acta0131.jpg,030601003.04.1.0001,179,447,14,640,0,0
388421_127981_0167Acta0067.jpg,030603013.01.1.0001,268,212,18,498,1,1
388421_214059_0318Acta0121.jpg,030701019.02.1.0001,99,258,6,363,0,0
388421_249893_0312Acta0119.jpg,030701007.03.1.0001,185,340,19,544,0,0
388421_262938_0324Acta0123.jpg,030701021.01.1.0001,150,297,6,453,0,0
388421_431567_0303Acta0116.jpg,030701009.01.1.0001,162,195,15,372,0,0
388421_483781_0149Acta0059.jpg,030601020.02.1.0001,76,308,2,386,0,0
388421_549355_0250Acta0094.jpg,030701010.01.1.0001,128,322,12,462,0,0
388421_610487_0268Acta0103.jpg,030603004.04.1.0001,175,337,15,527,0,0
388421_620381_0285Acta0109.jpg,030603018.01.1.0001,176,143,11,330,0,0
388421_660523_0294Acta0112.jpg,030601001.01.1.0001,160,151,5,316,0,0
388421_749912_0110Acta0046.jpg,030601014.01.1.0001,133,385,11,529,0,0
388421_769725_0106Acta0045.jpg,030601009.03.1.0001,132,425,6,563,0,0
388421_865559_0116Acta0049.jpg,030601012.04.1.0001,167,321,10,498,0,0
388421_894418_0380Acta0144.jpg,030602001.01.1.0001,151,299,3,453,0,0
388421_918371_0098Acta0043.jpg,030601007.02.1.0001,109,467,8,584,0,0
388421_927656_0364Acta0136.jpg,030601013.02.1.0001,114,356,5,475,0,0
388421_945321_0174Acta0070.jpg,030601017.01.1.0001,129,364,8,501,0,0
388421_970948_0377Acta0143.jpg,030602005.01.1.0001,221,104,5,330,1,1
407938_067935_0048Acta0039.jpg,060801001.04.1.0001,91,381,6,478,0,0
407938_112671_0040Acta0031.jpg,060801001.02.1.0001,71,398,8,477,0,0
407938_244308_0033Acta0024.jpg,060803002.01.1.0001,120,49,3,172,0,0
408106_000610_0300Acta0299.jpg,010102015.01.1.0001,81,324,9,414,1,1
408106_014130_0159Acta0159.jpg,010101002.03.1.0001,114,310,20,444,0,0
408106_015839_0093Acta0093.jpg,010113040.01.1.0001,142,308,17,467,0,0
408106_020452_0117Acta0117.jpg,010113037.01.1.0001,89,306,8,403,0,0
408106_025687_0402Acta0382.jpg,240101003.02.1.0001,179,355,20,554,0,0
408106_025854_0095Acta0095.jpg,010113009.01.1.0001,335,344,30,709,0,0
408106_045675_0197Acta0196.jpg,010106004.03.1.0001,136,344,17,497,0,0
408106_062904_0274Acta0273.jpg,010102008.01.1.0001,118,328,13,459,0,0
408106_073085_0185Acta0185.jpg,010101001.02.1.0001,137,271,8,416,0,0
408106_078444_0378Acta0365.jpg,010120008.03.1.0001,119,322,11,452,0,0
408106_086930_0362Acta0350.jpg,131602011.06.1.0001,36,383,7,426,0,0
408106_137863_0485Acta0401.jpg,240107012.02.1.0001,170,351,11,532,0,0
408106_151364_0344Acta0342.jpg,010106004.04.1.0001,140,372,23,535,0,0
408106_154205_0453Acta0394.jpg,240101010.03.1.0001,172,406,23,601,0,0
408106_163607_0334Acta0333.jpg,010121002.05.1.0001,138,276,12,426,0,0
408106_174162_0078Acta0078.jpg,010113019.03.1.0001,139,274,15,428,0,0
408106_188884_0443Acta0391.jpg,240101005.04.1.0001,134,421,13,568,0,0
408106_195959_0058Acta0058.jpg,010113003.01.1.0001,166,268,12,446,0,0
408106_205969_0184Acta0184.jpg,010101001.01.1.0001,114,323,12,449,0,0
408106_229218_0176Acta0176.jpg,010101031.01.1.0001,99,196,10,305,0,0
408106_244922_0277Acta0276.jpg,010102006.04.1.0001,81,356,11,448,0,0
408106_248529_0381Acta0367.jpg,131602011.03.1.0001,25,382,1,408,0,0
408106_253952_0289Acta0288.jpg,010102011.03.1.0001,75,302,11,388,0,0
408106_254178_0432Acta0389.jpg,240101017.01.1.0001,143,409,12,564,0,0
408106_292346_0431Acta0389.jpg,240101007.01.1.0001,53,360,10,423,0,0
408106_298133_0508Acta0408.jpg,240105011.01.1.0001,178,358,20,556,0,0
408106_306164_0244Acta0243.jpg,010105005.02.1.0001,138,275,13,426,0,0
408106_308183_0288Acta0287.jpg,010102011.04.1.0001,63,287,9,359,0,0
408106_317763_0280Acta0279.jpg,010102009.01.1.0001,54,349,10,413,0,0
408106_321331_0310Acta0309.jpg,010121007.03.1.0001,78,276,6,360,0,0
408106_330720_0419Acta0386.jpg,240107016.01.1.0001,178,303,17,498,0,0
408106_343965_0414Acta0385.jpg,240101013.01.1.0001,141,354,14,509,0,0
408106_345717_0079Acta0079.jpg,010113019.04.1.0001,153,278,14,445,0,0
408106_352074_0248Acta0247.jpg,010105017.01.1.0001,254,259,12,525,0,0
408106_378878_0264Acta0263.jpg,010105008.06.1.0001,183,267,9,459,0,0
408106_380933_0339Acta0338.jpg,010113017.02.1.0001,105,269,12,386,0,0
408106_387187_0096Acta0096.jpg,010113042.01.1.0001,120,232,12,364,0,0
408106_394825_0317Acta0316.jpg,010121008.05.1.0001,90,321,8,419,0,0
408106_397197_0240Acta0239.jpg,010105010.01.1.0001,272,321,21,614,1,1
408106_403866_0126Acta0126.jpg,010113028.06.1.0001,70,284,8,362,0,0
408106_417687_0251Acta0250.jpg,010105016.01.1.0001,228,377,22,627,0,0
408106_443216_0250Acta0249.jpg,010105017.02.1.0001,262,280,20,562,0,0
408106_455056_0111Acta0111.jpg,010113010.01.1.0001,43,258,5,306,0,0
408106_458816_0370Acta0357.jpg,010120008.02.1.0001,107,327,8,442,0,0
408106_459995_0367Acta0354.jpg,010120008.05.1.0001,92,331,9,432,0,0
408106_468364_0042Acta0042.jpg,010113015.03.1.0001,34,317,5,356,0,0
408106_491292_0450Acta0393.jpg,240101009.03.1.0001,148,400,18,566,0,0
408106_494418_0050Acta0050.jpg,010113011.01.1.0001,74,319,12,405,0,0
408106_500715_0394Acta0379.jpg,010107022.03.1.0001,146,344,14,504,0,0
408106_515999_0345Acta0343.jpg,010106011.04.1.0001,105,303,6,414,0,0
408106_518923_0266Acta0265.jpg,010105008.08.1.0001,183,278,8,469,0,0
408106_526500_0124Acta0124.jpg,010113028.04.1.0001,70,306,18,394,1,1
408106_548872_0313Acta0312.jpg,010121011.02.1.0001,111,259,10,380,0,0
408106_572474_0407Acta0384.jpg,240103004.02.1.0001,174,271,18,463,0,0
408106_589048_0290Acta0289.jpg,010102011.01.1.0001,77,296,5,378,0,0
408106_610064_0328Acta0327.jpg,010121004.01.1.0001,48,348,13,409,0,0
408106_623270_0448Acta0393.jpg,240101020.01.1.0001,206,260,17,483,0,0
408106_634121_0015Acta0015.jpg,010103006.01.1.0001,139,237,21,397,1,1
408106_638219_0041Acta0041.jpg,010113015.02.1.0001,46,358,6,410,0,0
408106_644086_0495Acta0403.jpg,240107014.01.1.0001,163,369,10,542,0,0
408106_648690_0374Acta0361.jpg,010120008.01.1.0001,77,341,6,424,0,0
408106_660117_0097Acta0097.jpg,010113042.02.1.0001,93,260,19,372,0,0
408106_668259_0043Acta0043.jpg,010113015.04.1.0001,38,360,7,405,0,0
408106_707730_0368Acta0355.jpg,010120006.01.1.0001,133,331,15,479,0,0
408106_737252_0114Acta0114.jpg,010113036.01.1.0001,133,351,14,498,0,0
408106_744217_0023Acta0023.jpg,010103004.02.1.0001,154,270,13,437,0,0
408106_756034_0420Acta0386.jpg,240107018.01.1.0001,200,313,12,525,0,0
408106_756389_0088Acta0088.jpg,010113025.02.1.0001,42,208,3,253,0,0
408106_756891_0237Acta0236.jpg,010105005.03.1.0001,144,291,17,452,0,0
408106_781710_0120Acta0120.jpg,010113037.04.1.0001,96,320,17,433,0,0
408106_786485_0396Acta0379.jpg,010107022.01.1.0001,124,346,15,485,0,0
408106_786568_0083Acta0083.jpg,010113019.06.1.0001,165,327,17,509,0,0
408106_788377_0202Acta0201.jpg,010106010.02.1.0001,104,351,13,468,1,1
408106_793729_0261Acta0260.jpg,010105008.03.1.0001,157,251,16,424,0,0
408106_804556_0181Acta0181.jpg,010101009.02.1.0001,108,360,18,486,0,0
408106_828336_0054Acta0054.jpg,010113011.05.1.0001,72,334,7,413,0,0
408106_830773_0205Acta0204.jpg,010106010.04.1.0001,110,370,20,500,0,0
408106_842572_0265Acta0264.jpg,010105008.07.1.0001,169,260,9,438,0,0
408106_851055_0123Acta0123.jpg,010113028.03.1.0001,66,302,15,383,1,1
408106_917155_0233Acta0232.jpg,010105026.03.1.0001,167,286,15,468,0,0
408106_926201_0115Acta0115.jpg,010113036.02.1.0001,115,318,21,454,0,0
408106_952082_0036Acta0036.jpg,010113024.02.1.0001,62,332,16,410,0,0
408106_958606_0312Acta0311.jpg,010121007.01.1.0001,56,240,6,302,0,0
408106_978178_0262Acta0261.jpg,010105008.04.1.0001,161,272,13,446,0,0
408106_983539_0410Acta0384.jpg,240103006.01.1.0001,309,290,24,623,0,0
408106_988182_0478Acta0399.jpg,240107013.02.1.0001,198,298,5,501,0,0
408106_996182_0099Acta0099.jpg,010113030.02.1.0001,113,298,7,418,0,0
413833_593436_0226Acta0042.jpg,060901021.01.1.0001,124,122,20,266,0,0
417922_011681_0178Acta0166.jpg,150501005.01.1.0001,167,372,16,555,0,0
417922_169800_0115Acta0103.jpg,150901020.01.1.0001,167,371,18,556,0,0
417922_177918_0154Acta0142.jpg,150901014.01.1.0001,169,237,11,417,0,0
417922_216956_0127Acta0115.jpg,150201003.01.1.0001,129,375,13,517,0,0
417922_221024_0200Acta0188.jpg,150201005.02.1.0001,124,447,8,579,0,0
417922_265963_0145Acta0133.jpg,150901017.01.1.0001,100,191,3,294,0,0
417922_297134_0140Acta0128.jpg,150901016.01.1.0001,89,118,5,212,0,0
417922_355818_0269Acta0257.jpg,150202002.02.1.0001,203,387,22,612,0,0
417922_527664_0272Acta0260.jpg,150201022.01.1.0001,170,203,13,386,0,0
417922_540850_0203Acta0191.jpg,150201001.02.1.0001,117,367,13,497,0,0
417922_587637_0211Acta0199.jpg,150202013.01.1.0001,198,227,13,438,0,0
417922_615821_0258Acta0246.jpg,150303001.01.1.0001,140,346,10,496,0,0
417922_641653_0110Acta0098.jpg,150902002.02.1.0001,129,411,6,546,0,0
417922_688845_0116Acta0104.jpg,150901020.03.1.0001,153,384,15,552,0,0
417922_724683_0202Acta0190.jpg,150201010.01.1.0001,96,329,8,433,0,0
417922_778209_0113Acta0101.jpg,150902006.01.1.0001,128,189,11,328,0,0
417922_780952_0176Acta0164.jpg,150501012.01.1.0001,254,281,11,546,0,0
417922_895542_0183Acta0171.jpg,150201009.01.1.0001,173,344,15,532,0,0
417922_954956_0173Acta0161.jpg,150501001.01.1.0001,144,303,9,456,0,0
417922_955284_0289Acta0277.jpg,150501002.01.1.0001,139,316,9,464,0,0
417922_975357_0284Acta0272.jpg,150305005.01.1.0001,153,340,8,501,0,0
417922_976918_0251Acta0239.jpg,150305001.02.1.0001,82,351,15,448,0,0
437250_098185_0288Acta0288.jpg,141001003.02.1.0001,193,240,11,444,0,0
437250_178288_0260Acta0260.jpg,140604005.01.1.0001,156,140,12,308,0,0
437250_362646_0267Acta0267.jpg,141301007.01.1.0001,113,182,9,304,0,0
437250_511638_0250Acta0250.jpg,140601001.01.1.0001,142,329,8,479,0,0
437250_570321_0281Acta0281.jpg,141001001.01.1.0001,189,227,7,423,0,0
437250_821352_0291Acta0291.jpg,141001007.02.1.0001,226,230,9,465,0,0
437250_932239_0261Acta0261.jpg,141301002.01.1.0001,171,332,11,514,0,0
441267_032394_0134Acta0134.jpg,091501002.02.1.0001,72,381,7,460,0,0
441267_148378_0105Acta0105.jpg,091201014.02.1.0001,73,299,8,380,0,0
441267_186902_0122Acta0122.jpg,090101002.01.1.0001,96,179,2,277,0,0
441267_351835_0114Acta0114.jpg,091202006.01.1.0001,105,276,7,388,0,0
441267_419591_0089Acta0089.jpg,091201005.02.1.0001,87,458,8,553,0,0
441267_495425_0115Acta0115.jpg,090101001.03.1.0001,91,348,11,450,0,0
441267_635226_0136Acta0136.jpg,091501005.01.1.0001,115,231,18,364,0,0
441267_752075_0092Acta0092.jpg,091201006.01.1.0001,133,344,11,488,0,0
441267_930863_0098Acta0098.jpg,091201003.02.1.0001,100,440,9,549,0,0
443074_004560_0423Acta0423.jpg,131001021.03.1.0001,165,380,19,564,0,0
443074_005143_0185Acta0185.jpg,130501008.03.1.0001,261,302,17,580,0,0
443074_008773_0294Acta0294.jpg,131201005.03.1.0001,136,427,18,581,0,0
443074_018440_0258Acta0258.jpg,130501027.02.1.0001,296,198,23,517,0,0
443074_021199_0213Acta0213.jpg,130501014.01.1.0001,227,263,16,506,0,0
443074_031023_0334Acta0334.jpg,131201012.03.1.0001,93,407,15,515,0,0
443074_051251_0413Acta0413.jpg,131001013.02.1.0001,137,370,20,527,0,0
443074_059249_0305Acta0305.jpg,131201006.02.1.0001,213,302,28,543,1,1
443074_106101_0177Acta0177.jpg,130501016.03.1.0001,153,305,13,471,1,1
443074_154066_0236Acta0236.jpg,130501018.02.1.0001,200,274,17,491,0,0
443074_226313_0281Acta0281.jpg,130501032.01.1.0001,139,409,21,569,0,0
443074_236102_0317Acta0317.jpg,131201024.03.1.0001,194,225,21,440,0,0
443074_289650_0517Acta0517.jpg,131001004.03.1.0001,181,364,21,566,0,0
443074_348432_0471Acta0471.jpg,131001013.01.1.0001,108,377,5,490,0,0
443074_356755_0263Acta0263.jpg,130501009.03.1.0001,240,246,21,507,0,0
443074_368325_0210Acta0210.jpg,130501015.03.1.0001,283,268,28,579,0,0
443074_396143_0303Acta0303.jpg,131201016.03.1.0001,153,307,24,484,0,0
443074_406851_0197Acta0197.jpg,130501001.02.1.0001,210,275,8,493,0,0
443074_432476_0395Acta0395.jpg,131001012.01.1.0001,137,306,12,455,0,0
443074_434836_0510Acta0510.jpg,131001004.01.1.0001,176,347,26,549,0,0
443074_440615_0439Acta0439.jpg,131001014.03.1.0001,160,273,20,453,0,0
443074_445349_0160Acta0160.jpg,130501003.01.1.0001,236,407,19,662,0,0
443074_468040_0498Acta0498.jpg,131001001.01.1.0001,146,339,10,495,0,0
443074_549730_0476Acta0476.jpg,131001008.02.1.0001,103,281,14,398,0,0
443074_559557_0318Acta0318.jpg,131201020.01.1.0001,240,252,31,523,0,0
443074_593931_0396Acta0396.jpg,131002003.02.1.0001,230,164,15,409,0,0
443074_613271_0438Acta0438.jpg,131001014.02.1.0001,138,277,25,440,0,0
443074_667527_0261Acta0261.jpg,130501009.02.1.0001,222,275,18,515,0,0
443074_696553_0183Acta0183.jpg,130501008.06.1.0001,323,315,30,668,0,0
443074_835450_0173Acta0173.jpg,130501022.01.1.0001,211,169,14,394,0,0
443074_837265_0501Acta0501.jpg,131001001.02.1.0001,142,324,10,476,0,0
443074_886416_0176Acta0176.jpg,130501016.02.1.0001,138,274,13,425,0,0
443074_887871_0259Acta0259.jpg,130501027.01.1.0001,327,184,21,532,1,1
443074_957586_0393Acta0393.jpg,131001044.01.1.0001,74,122,7,203,0,0
443074_960878_0362Acta0362.jpg,131201030.02.1.0001,115,168,19,302,0,0
443074_994799_0242Acta0242.jpg,130501013.03.1.0001,209,259,23,491,0,0
443074_996519_0337Acta0337.jpg,131201011.03.1.0001,86,378,15,479,0,0
454356_056744_0767Acta0266.jpg,170601016.02.1.0001,182,281,16,479,0,0
454356_175335_0795Acta0294.jpg,171501005.04.1.0001,282,205,18,505,0,0
454356_226516_0737Acta0236.jpg,171401023.01.1.0001,451,288,11,750,0,0
454356_228840_0676Acta0176.jpg,170703002.02.1.0001,325,67,10,402,0,0
454356_447192_0769Acta0268.jpg,170601004.01.1.0001,233,307,13,553,0,0
454356_470853_0691Acta0191.jpg,170706002.03.1.0001,337,182,14,533,0,0
454356_483451_0808Acta0307.jpg,171501004.01.1.0001,197,159,9,365,0,0
454356_540587_0791Acta0290.jpg,171502001.01.1.0001,287,334,21,642,0,0
454356_589046_0759Acta0258.jpg,171401003.02.1.0001,279,302,5,586,0,0
454356_798401_0760Acta0259.jpg,171401003.03.1.0001,293,279,10,582,0,0
454356_853855_0678Acta0178.jpg,170703007.02.1.0001,223,160,10,393,0,0
454402_017637_0504Acta0466.jpg,150601006.02.1.0001,113,334,16,463,0,0
454402_051409_0347Acta0309.jpg,150601001.01.1.0001,154,418,7,579,0,0
454402_056346_0399Acta0361.jpg,150402003.03.1.0001,91,459,9,559,0,0
454402_095165_0363Acta0325.jpg,150101002.02.1.0001,121,416,17,554,0,0
454402_101824_0321Acta0283.jpg,150601011.02.1.0001,90,363,13,466,0,0
454402_175875_0348Acta0310.jpg,150601002.04.1.0001,225,311,20,556,0,0
454402_216180_0400Acta0362.jpg,150402003.02.1.0001,84,440,10,534,0,0
454402_226850_0292Acta0254.jpg,150402004.02.1.0001,41,374,5,420,0,0
454402_235121_0501Acta0463.jpg,151102004.02.1.0001,86,273,8,367,1,1
454402_235882_0334Acta0296.jpg,150601003.01.1.0001,172,364,23,559,0,0
454402_249781_0338Acta0300.jpg,150601015.02.1.0001,123,358,13,494,0,0
454402_292146_0314Acta0276.jpg,150601021.03.1.0001,110,347,21,478,0,0
454402_360169_0451Acta0413.jpg,151001011.01.1.0001,118,306,7,431,0,0
454402_360725_0496Acta0458.jpg,150401006.01.1.0001,96,349,15,460,0,0
454402_395335_0369Acta0331.jpg,150101001.01.1.0001,103,318,16,437,0,0
454402_406755_0298Acta0260.jpg,150402001.02.1.0001,78,358,10,446,0,0
454402_409022_0371Acta0333.jpg,150101007.03.1.0001,143,459,23,625,0,0
454402_431739_0421Acta0383.jpg,151102014.01.1.0001,121,314,11,446,0,0
454402_440891_0390Acta0352.jpg,150401001.03.1.0001,80,339,11,430,0,0
454402_473005_0471Acta0433.jpg,151001007.02.1.0001,167,276,8,451,0,0
454402_480400_0317Acta0279.jpg,150601023.02.1.0001,130,335,20,485,0,0
454402_506430_0500Acta0462.jpg,151102004.01.1.0001,95,265,9,369,0,0
454402_524592_0315Acta0277.jpg,150601021.04.1.0001,139,353,15,507,0,0
454402_533954_0364Acta0326.jpg,150101005.02.1.0001,170,414,15,599,0,0
454402_535297_0346Acta0308.jpg,150601001.02.1.0001,158,416,21,595,0,0
454402_561129_0547Acta0509.jpg,150601021.01.1.0001,113,341,11,465,0,0
454402_622577_0454Acta0416.jpg,151001009.02.1.0001,173,196,8,377,0,0
454402_625380_0545Acta0507.jpg,150601029.02.1.0001,164,315,16,495,0,0
454402_647661_0336Acta0298.jpg,150601034.02.1.0001,70,246,3,319,0,0
454402_683745_0381Acta0343.jpg,150401005.02.1.0001,111,408,9,528,0,0
454402_702600_0352Acta0314.jpg,150601019.02.1.0001,58,300,7,365,0,0
454402_709002_0293Acta0255.jpg,150402004.01.1.0001,32,359,4,395,0,0
454402_746486_0494Acta0456.jpg,150101009.01.1.0001,106,429,16,551,0,0
454402_754094_0444Acta0406.jpg,151001020.01.1.0001,105,69,4,178,0,0
454402_817686_0297Acta0259.jpg,150401002.04.1.0001,84,352,12,448,0,0
454402_834834_0387Acta0349.jpg,150401007.02.1.0001,80,271,6,357,0,0
454402_860618_0281Acta0243.jpg,150101004.01.1.0001,74,373,13,460,0,0
454402_868533_0464Acta0426.jpg,151001013.02.1.0001,177,220,5,402,0,0
454402_932548_0367Acta0329.jpg,150101001.03.1.0001,81,358,9,448,0,0
454402_972531_0525Acta0487.jpg,150601022.02.1.0001,68,242,13,323,0,0
454402_997956_0372Acta0334.jpg,150101007.02.1.0001,158,462,23,643,0,0
454417_343884_0354Acta0098.jpg,060605002.01.1.0001,196,237,17,450,0,0
454417_769504_0379Acta0123.jpg,060601002.01.1.0001,180,219,6,405,0,0
454446_001520_0274Acta0203.jpg,010110041.02.1.0001,139,353,23,515,0,0
454446_033423_0291Acta0214.jpg,010120015.04.1.0001,79,266,16,361,0,0
454446_059822_0030Acta0027.jpg,010120033.02.1.0001,250,494,16,760,0,0
454446_073396_0174Acta0137.jpg,010119005.04.1.0001,128,380,21,529,0,0
454446_082009_0307Acta0225.jpg,010120010.02.1.0001,77,277,11,365,0,0
454446_135422_0238Acta0180.jpg,010114020.04.1.0001,184,365,22,571,0,0
454446_135906_0133Acta0114.jpg,010108002.03.1.0001,126,316,15,457,0,0
454446_149254_0218Acta0162.jpg,010114037.01.1.0001,237,296,21,554,0,0
454446_175600_0182Acta0140.jpg,010119001.03.1.0001,92,331,9,432,1,1
454446_179548_0108Acta0105.jpg,010108001.02.1.0001,187,313,5,505,0,0
454446_184747_0300Acta0220.jpg,010102017.04.1.0001,117,443,17,577,1,1
454446_215662_0061Acta0058.jpg,010120002.02.1.0001,62,293,8,363,0,0
454446_217900_0037Acta0034.jpg,010120025.03.1.0001,67,315,4,386,0,0
454446_223235_0031Acta0028.jpg,010120017.01.1.0001,172,309,6,487,0,0
454446_230496_0112Acta0106.jpg,010108040.03.1.0001,115,299,17,431,0,0
454446_237342_0131Acta0113.jpg,010108007.04.1.0001,211,342,23,576,1,1
454446_244597_0298Acta0220.jpg,010102017.02.1.0001,130,413,19,562,0,0
454446_250545_0193Acta0148.jpg,010114015.01.1.0001,247,335,25,607,0,0
454446_260259_0080Acta0077.jpg,010108020.01.1.0001,147,319,5,471,0,0
454446_265314_0095Acta0092.jpg,010108028.03.1.0001,145,374,21,540,0,0
454446_271524_0253Acta0188.jpg,010114054.01.1.0001,236,380,22,638,0,0
454446_293381_0246Acta0184.jpg,010114023.04.1.0001,136,320,18,474,0,0
454446_312457_0020Acta0017.jpg,010120022.02.1.0001,83,324,4,411,0,0
454446_346707_0199Acta0152.jpg,010119012.03.1.0001,137,349,9,495,1,1
454446_370338_0042Acta0039.jpg,010120006.04.1.0001,111,342,15,468,0,0
454446_387586_0056Acta0053.jpg,010120023.03.1.0001,120,497,14,631,0,0
454446_447888_0142Acta0118.jpg,010108026.02.1.0001,180,380,16,576,0,0
454446_546202_0282Acta0210.jpg,010110009.04.1.0001,189,336,19,544,0,0
454446_550540_0201Acta0153.jpg,010119003.07.1.0001,180,316,7,503,0,0
454446_568150_0233Acta0175.jpg,010114026.01.1.0001,143,393,15,551,0,0
454446_584457_0208Acta0157.jpg,010119003.01.1.0001,188,293,10,491,0,0
454446_586726_0059Acta0056.jpg,010120007.02.1.0001,66,308,7,381,0,0
454446_640083_0296Acta0218.jpg,010102019.01.1.0001,111,403,17,531,0,0
454446_685788_0271Acta0200.jpg,010110006.01.1.0001,221,351,23,595,0,0
454446_778255_0139Acta0117.jpg,010108004.01.1.0001,151,346,13,510,0,0
454446_798137_0158Acta0128.jpg,010119007.03.1.0001,252,398,23,673,0,0
454446_820359_0295Acta0217.jpg,010120015.02.1.0001,84,286,11,381,0,0
454446_834518_0029Acta0026.jpg,010120033.01.1.0001,249,504,24,777,0,0
454446_835707_0048Acta0045.jpg,010120027.02.1.0001,107,356,10,473,0,0
454446_837162_0134Acta0114.jpg,010108002.02.1.0001,120,344,12,476,0,0
454446_846080_0040Acta0037.jpg,010120006.02.1.0001,115,345,10,470,0,0
454446_857320_0124Acta0112.jpg,010108007.03.1.0001,230,355,22,607,0,0
454446_877984_0262Acta0194.jpg,010112019.03.1.0001,70,312,11,393,0,0
454446_897141_0086Acta0083.jpg,010108021.03.1.0001,155,330,18,503,0,0
454446_954567_0057Acta0054.jpg,010120007.01.1.0001,84,310,10,404,1,1
454446_963170_0240Acta0182.jpg,010114029.01.1.0001,188,289,16,493,1,1
454446_977396_0185Acta0143.jpg,010119008.02.1.0001,156,425,26,607,0,0
454446_979217_0181Acta0140.jpg,010119001.02.1.0001,99,318,13,430,0,0
454450_010947_0048Acta0047.jpg,040103020.01.1.0001,70,347,5,422,0,0
454450_019330_0215Acta0214.jpg,040104001.04.1.0001,98,298,17,413,0,0
454450_115154_0172Acta0171.jpg,040104011.05.1.0001,63,388,5,456,1,1
454450_120099_0056Acta0055.jpg,040103018.02.1.0001,55,220,5,280,0,0
454450_141746_0315Acta0314.jpg,040104011.02.1.0001,66,418,14,498,0,0
454450_162647_0206Acta0205.jpg,040104008.03.1.0001,68,344,12,424,0,0
454450_207708_0287Acta0286.jpg,040103013.02.1.0001,139,354,14,507,1,1
454450_234592_0062Acta0061.jpg,040105010.01.1.0001,83,362,14,459,1,1
454450_269513_0065Acta0064.jpg,040105016.02.1.0001,76,384,11,471,0,0
454450_275684_0160Acta0159.jpg,040105006.01.1.0001,184,382,25,591,0,0
454450_279574_0311Acta0310.jpg,040103005.03.1.0001,52,395,8,455,0,0
454450_280459_0280Acta0279.jpg,040103012.01.1.0001,55,335,3,393,0,0
454450_299520_0156Acta0155.jpg,040101002.01.1.0001,113,377,10,500,0,0
454450_305162_0161Acta0160.jpg,040105006.02.1.0001,179,357,26,562,0,0
454450_325797_0175Acta0174.jpg,040104003.03.1.0001,89,414,8,511,0,0
454450_359924_0051Acta0050.jpg,040103020.04.1.0001,89,371,6,466,0,0
454450_363516_0243Acta0242.jpg,040105008.04.1.0001,126,329,21,476,0,0
454450_406627_0015Acta0015.jpg,040103021.01.1.0001,54,342,13,409,0,0
454450_408505_0103Acta0102.jpg,040106005.02.1.0001,46,370,5,421,0,0
454450_412377_0066Acta0065.jpg,040106018.01.1.0001,177,387,21,585,0,0
454450_412689_0122Acta0121.jpg,040101011.01.1.0001,98,376,12,486,0,0
454450_473989_0177Acta0176.jpg,040101019.02.1.0001,117,338,10,465,0,0
454450_508462_0188Acta0187.jpg,040104021.01.1.0001,111,387,9,507,0,0
454450_520468_0317Acta0316.jpg,040104016.02.1.0001,80,340,7,427,0,0
454450_540908_0037Acta0036.jpg,040103002.03.1.0001,59,370,8,437,0,0
454450_631389_0080Acta0079.jpg,040106011.03.1.0001,138,388,10,536,0,0
454450_638233_0318Acta0317.jpg,040105007.01.1.0001,105,230,17,352,0,0
454450_691605_0319Acta0318.jpg,040102002.01.1.0001,190,214,20,424,0,0
454450_729134_0125Acta0124.jpg,040101011.04.1.0001,115,391,14,520,0,0
454450_735874_0263Acta0262.jpg,040105019.01.1.0001,115,314,12,441,0,0
454450_756750_0121Acta0120.jpg,040101003.03.1.0001,72,288,13,373,0,0
454450_818239_0297Acta0296.jpg,040101003.04.1.0001,94,317,10,421,0,0
454450_829931_0049Acta0048.jpg,040103020.02.1.0001,64,340,11,415,0,0
454450_836601_0073Acta0072.jpg,040106014.04.1.0001,133,327,17,477,0,0
454450_837780_0295Acta0294.jpg,040103008.03.1.0001,119,413,20,552,0,0
454450_851851_0174Acta0173.jpg,040104003.02.1.0001,77,365,8,450,0,0
454450_881755_0074Acta0073.jpg,040106016.01.1.0001,123,286,8,417,0,0
454450_892623_0075Acta0074.jpg,040106016.02.1.0001,128,295,12,435,1,1
454450_934400_0138Acta0137.jpg,040101010.04.1.0001,88,338,16,442,0,0
454450_990884_0248Acta0247.jpg,040105014.01.1.0001,155,314,33,502,0,0
454455_131444_0023Acta0019.jpg,060502001.01.1.0001,103,197,5,305,0,0
454455_256421_0049Acta0029.jpg,061001002.01.1.0001,95,458,11,564,0,0
454455_381450_0070Acta0039.jpg,060501015.01.1.0001,17,63,1,81,0,0
454495_057115_0458Acta0396.jpg,130402006.03.1.0001,252,301,22,575,0,0
454495_082750_0252Acta0192.jpg,130402003.01.1.0001,235,228,16,479,0,0
454495_099952_0283Acta0223.jpg,131502012.01.1.0001,269,91,12,372,0,0
454495_125130_0402Acta0340.jpg,130701021.04.1.0001,168,241,24,433,0,0
454495_275344_0195Acta0136.jpg,130401012.04.1.0001,205,271,24,500,0,0
454495_281815_0423Acta0361.jpg,130701006.03.1.0001,193,313,22,528,1,1
454495_286430_0211Acta0152.jpg,130401022.01.1.0001,206,269,23,498,0,0
454495_332796_0386Acta0324.jpg,130701025.02.1.0001,244,266,23,533,0,0
454495_336380_0428Acta0366.jpg,131502010.02.1.0001,254,191,22,467,0,0
454495_424111_0216Acta0157.jpg,130401029.01.1.0001,129,246,19,394,0,0
454495_484317_0197Acta0138.jpg,130401012.02.1.0001,188,294,21,503,0,0
454495_501658_0333Acta0273.jpg,130402011.04.1.0001,180,293,16,489,0,0
454495_524731_0230Acta0170.jpg,130401010.01.1.0001,165,395,11,571,0,0
454495_594424_0403Acta0341.jpg,130701021.05.1.0001,182,288,20,490,0,0
454495_702843_0251Acta0191.jpg,130402003.02.1.0001,203,263,23,489,0,0
454495_727539_0296Acta0236.jpg,131502005.01.1.0001,168,151,8,327,0,0
454495_793536_0219Acta0160.jpg,130401007.03.1.0001,199,414,13,626,0,0
454495_797863_0387Acta0325.jpg,130701025.04.1.0001,243,302,31,576,0,0
454495_851602_0336Acta0276.jpg,130402011.07.1.0001,187,301,21,509,1,1
454495_923303_0391Acta0329.jpg,130701025.03.1.0001,250,271,31,552,0,0
454495_932151_0290Acta0230.jpg,131501014.02.1.0001,99,267,11,377,0,0
459099_107103_0043Acta0043.jpg,130104012.01.1.0001,147,159,12,318,0,0
459099_505795_0027Acta0027.jpg,130106013.01.1.0001,125,89,8,222,0,0
459099_850899_0067Acta0067.jpg,130101009.01.1.0001,335,154,26,515,0,0
459099_912433_0018Acta0018.jpg,130106017.01.1.0001,107,94,5,206,0,0
459339_037152_0588Acta0219.jpg,140201017.01.1.0001,131,228,8,367,0,0
459339_102442_0498Acta0187.jpg,140201009.01.1.0001,164,248,11,423,0,0
459339_125848_0491Acta0185.jpg,140201008.01.1.0001,256,266,5,527,0,0
459339_126023_0532Acta0200.jpg,140706026.02.1.0001,124,299,14,437,0,0
459339_185924_0283Acta0081.jpg,140710018.03.1.0001,119,392,6,517,0,0
459339_248989_0374Acta0124.jpg,140710008.01.1.0001,143,340,12,495,0,0
459339_271411_0431Acta0152.jpg,140706010.02.1.0001,98,263,9,370,0,0
459339_275828_0384Acta0128.jpg,140710015.01.1.0001,183,373,8,564,0,0
459339_282691_0409Acta0142.jpg,140708004.02.1.0001,102,244,9,355,0,0
459339_287984_0568Acta0214.jpg,140702002.01.1.0001,178,249,7,434,0,0
459339_299688_0218Acta0044.jpg,140709004.02.1.0001,157,392,17,566,0,0
459339_305457_0569Acta0214.jpg,140702004.01.1.0001,316,196,14,526,0,0
459339_337209_0224Acta0050.jpg,140709008.01.1.0001,130,438,14,582,0,0
459339_344812_0659Acta0238.jpg,140711028.01.1.0001,317,305,9,631,0,0
459339_354069_0403Acta0140.jpg,140708002.01.1.0001,125,302,7,434,0,0
459339_369183_0734Acta0268.jpg,140708008.06.1.0001,104,379,10,493,0,0
459339_444837_0363Acta0117.jpg,140708015.02.1.0001,107,327,4,438,0,0
459339_447082_0694Acta0252.jpg,140707008.04.1.0001,115,346,20,481,0,0
459339_455493_0399Acta0137.jpg,140706012.01.1.0001,172,348,12,532,0,0
459339_467275_0720Acta0264.jpg,140711016.02.1.0001,182,276,12,470,0,0
459339_491188_0382Acta0127.jpg,140707017.01.1.0001,111,218,2,331,0,0
459339_497859_0732Acta0268.jpg,140708008.04.1.0001,126,385,11,522,0,0
459339_520640_0444Acta0159.jpg,140706004.02.1.0001,129,284,8,421,0,0
459339_521015_0626Acta0229.jpg,140901009.01.1.0001,108,189,10,307,0,0
459339_623573_0196Acta0027.jpg,140710017.01.1.0001,134,341,12,487,0,0
459339_633749_0735Acta0269.jpg,140711032.01.1.0001,72,35,2,109,0,0
459339_676030_0587Acta0219.jpg,140201001.03.1.0001,151,303,8,462,0,0
459339_676641_0583Acta0218.jpg,140201019.02.1.0001,144,284,8,436,0,0
459339_681470_0502Acta0187.jpg,140201015.01.1.0001,162,240,15,417,0,0
459339_688502_0228Acta0054.jpg,140709008.05.1.0001,122,441,13,576,0,0
459339_708009_0486Acta0184.jpg,140201003.01.1.0001,105,207,5,317,0,0
459339_772106_0632Acta0230.jpg,140901002.02.1.0001,97,232,10,339,0,0
459339_854555_0656Acta0237.jpg,140902007.01.1.0001,209,131,3,343,0,0
459339_880984_0338Acta0108.jpg,140706007.01.1.0001,126,349,10,485,0,0
459339_913207_0537Acta0203.jpg,140706031.02.1.0001,212,295,9,516,0,0
459339_915137_0509Acta0190.jpg,140201002.01.1.0001,279,212,8,499,0,0
462591_010043_0251Acta0238.jpg,021302005.01.1.0001,136,352,22,510,0,0
462591_013011_0068Acta0055.jpg,021501001.02.1.0001,68,268,4,340,0,0
462591_027641_0269Acta0256.jpg,021301021.04.1.0001,174,428,18,620,0,0
462591_030312_0059Acta0046.jpg,021302010.03.1.0001,128,381,11,520,0,0
462591_037019_0054Acta0041.jpg,021302007.01.1.0001,152,313,14,479,0,0
462591_078357_0045Acta0032.jpg,021302009.01.1.0001,93,312,6,411,0,0
462591_117315_0249Acta0236.jpg,021302004.04.1.0001,209,364,21,594,0,0
462591_142845_0094Acta0081.jpg,021501017.02.1.0001,122,319,14,455,0,0
462591_153650_0259Acta0246.jpg,021302022.01.1.0001,119,356,10,485,0,0
462591_170134_0210Acta0197.jpg,021301020.02.1.0001,160,425,16,601,0,0
462591_207175_0133Acta0120.jpg,021302002.05.1.0001,143,384,7,534,0,0
462591_284846_0169Acta0156.jpg,021301028.01.1.0001,178,365,22,565,0,0
462591_411434_0085Acta0072.jpg,021501002.03.1.0001,108,359,9,476,0,0
462591_447886_0165Acta0152.jpg,021301028.02.1.0001,197,362,18,577,0,0
462591_475360_0106Acta0093.jpg,021502007.01.1.0001,184,228,12,424,0,0
462591_482636_0215Acta0202.jpg,021301020.03.1.0001,148,449,11,608,0,0
462591_492481_0219Acta0206.jpg,021301001.02.1.0001,103,317,14,434,0,0
462591_579094_0304Acta0291.jpg,021301084.02.1.0001,178,214,9,401,0,0
462591_608184_0064Acta0051.jpg,021302008.03.1.0001,139,425,12,576,0,0
462591_641093_0072Acta0059.jpg,021502001.02.1.0001,194,410,21,625,0,0
462591_665104_0262Acta0249.jpg,021302005.03.1.0001,111,335,8,454,0,0
462591_699365_0157Acta0144.jpg,021301032.04.1.0001,122,457,10,589,0,0
462591_718396_0297Acta0284.jpg,021302018.03.1.0001,200,342,22,564,0,0
462591_761878_0134Acta0121.jpg,021302002.02.1.0001,136,327,15,478,0,0
462591_776068_0220Acta0207.jpg,021301001.03.1.0001,94,341,9,444,0,0
462591_781687_0221Acta0208.jpg,021301001.04.1.0001,101,363,14,478,0,0
462591_782979_0253Acta0240.jpg,021301087.02.1.0001,139,322,8,469,0,0
462591_882574_0177Acta0164.jpg,021301057.02.1.0001,115,407,15,537,0,0
462591_950677_0231Acta0218.jpg,021301011.04.1.0001,129,419,10,558,0,0
462591_970634_0137Acta0124.jpg,021302002.03.1.0001,122,363,9,494,0,0
462591_993627_0150Acta0137.jpg,021301015.03.1.0001,155,365,18,538,0,0
465290_028082_0376Acta0091.jpg,130901045.01.1.0001,179,296,14,489,0,0
465290_088631_0436Acta0151.jpg,130901039.03.1.0001,62,291,13,366,0,0
465290_107079_0397Acta0112.jpg,130901023.03.1.0001,50,382,9,441,0,0
465290_156696_0398Acta0113.jpg,130901023.01.1.0001,33,349,6,388,0,0
465290_342760_0424Acta0139.jpg,130901008.06.1.0001,52,309,5,366,0,0
465290_427558_0409Acta0124.jpg,130901057.04.1.0001,156,450,19,625,0,0
465290_431856_0466Acta0163.jpg,130901030.04.1.0001,35,308,7,350,0,0
465290_633799_0388Acta0103.jpg,130901095.05.1.0001,190,333,15,538,0,0
465290_675511_0395Acta0110.jpg,130901023.02.1.0001,30,338,5,373,0,0
465290_764676_0370Acta0085.jpg,130904002.01.1.0001,180,390,18,588,1,1
465290_840901_0454Acta0157.jpg,130901041.01.1.0001,70,400,8,478,0,0
465290_907799_0407Acta0122.jpg,130901057.01.1.0001,154,377,21,552,0,0
465290_973655_0404Acta0119.jpg,130901090.01.1.0001,105,379,10,494,0,0
465290_982737_0434Acta0149.jpg,130901039.01.1.0001,50,310,13,373,0,0
474306_010500_0219Acta0112.jpg,140102004.01.1.0001,349,272,9,630,0,0
474306_152096_0159Acta0086.jpg,140304002.01.1.0001,151,134,9,294,0,0
474306_293363_0128Acta0063.jpg,140804001.02.1.0001,171,214,9,394,0,0
474306_360598_0166Acta0087.jpg,140302003.02.1.0001,194,153,2,349,0,0
474306_382707_0216Acta0111.jpg,140102001.02.1.0001,306,343,5,654,0,0
474306_565556_0161Acta0086.jpg,140306001.02.1.0001,235,252,13,500,0,0
476204_006820_0282Acta0116.jpg,060106012.01.1.0001,78,373,12,463,0,0
476204_030928_0265Acta0108.jpg,060106004.02.1.0001,37,303,4,344,0,0
476204_030983_0141Acta0052.jpg,060107008.04.1.0001,59,334,5,398,0,0
476204_083895_0300Acta0122.jpg,060106015.03.1.0001,33,353,2,388,0,0
476204_119960_0569Acta0233.jpg,060103002.02.1.0001,148,318,15,481,0,0
476204_134051_0150Acta0055.jpg,060107009.05.1.0001,45,276,3,324,0,0
476204_134085_0479Acta0199.jpg,060108056.01.1.0001,168,273,16,457,0,0
476204_170529_0330Acta0136.jpg,060105009.03.1.0001,167,361,17,545,0,0
476204_180157_0347Acta0145.jpg,060103010.01.1.0001,201,275,26,502,0,0
476204_183295_0534Acta0220.jpg,060105004.02.1.0001,125,336,8,469,0,0
476204_192133_0331Acta0136.jpg,060105009.04.1.0001,134,421,23,578,0,0
476204_206832_0387Acta0167.jpg,060108007.02.1.0001,117,371,20,508,0,0
476204_293148_0261Acta0106.jpg,060106002.03.1.0001,112,293,9,414,0,0
476204_293984_0066Acta0023.jpg,060108015.02.1.0001,97,361,10,468,0,0
476204_341791_0268Acta0109.jpg,060106005.03.1.0001,77,359,5,441,0,0
476204_357602_0082Acta0027.jpg,060108019.02.1.0001,88,371,16,475,0,0
476204_358787_0538Acta0221.jpg,060105004.04.1.0001,142,346,21,509,2,2
476204_466045_0267Acta0109.jpg,060106005.02.1.0001,66,335,13,414,0,0
476204_497237_0499Acta0206.jpg,060101022.03.1.0001,154,314,18,486,0,0
476204_540848_0512Acta0210.jpg,060101027.05.1.0001,109,424,13,546,1,1
476204_551165_0523Acta0215.jpg,060105010.03.1.0001,144,380,14,538,0,0
476204_594247_0463Acta0194.jpg,060108012.04.1.0001,112,309,12,433,0,0
476204_643590_0103Acta0034.jpg,060108003.02.1.0001,69,239,8,316,0,0
476204_648633_0132Acta0049.jpg,060107007.01.1.0001,84,334,6,424,0,0
476204_653971_0458Acta0191.jpg,060108020.05.1.0001,74,348,12,434,0,0
476204_680520_0329Acta0136.jpg,060105009.02.1.0001,165,353,14,532,0,0
476204_702888_0275Acta0112.jpg,060106006.02.1.0001,68,366,11,445,1,1
476204_722850_0321Acta0133.jpg,060105016.04.1.0001,139,372,9,520,0,0
476204_725462_0202Acta0074.jpg,060101006.01.1.0001,144,326,16,486,0,0
476204_758134_0309Acta0127.jpg,060105021.01.1.0001,121,298,8,427,0,0
476204_838610_0549Acta0226.jpg,060101005.03.1.0001,120,420,10,550,0,0
476204_840922_0251Acta0100.jpg,060101035.01.1.0001,107,186,6,299,0,0
476204_853367_0120Acta0043.jpg,060107002.02.1.0001,54,350,4,408,0,0
476204_860063_0521Acta0214.jpg,060105010.02.1.0001,134,386,12,532,0,0
476204_866941_0328Acta0136.jpg,060105009.01.1.0001,147,355,22,524,0,0
476204_881842_0257Acta0104.jpg,060101007.05.1.0001,90,436,4,530,0,0
476204_889698_0081Acta0027.jpg,060108019.01.1.0001,75,426,15,516,0,0
476204_957429_0239Acta0094.jpg,060101023.03.1.0001,158,348,9,515,0,0
476204_985162_0146Acta0055.jpg,060107009.01.1.0001,38,280,9,327,0,0
480196_015829_0445Acta0393.jpg,211005001.03.1.0001,41,313,2,356,0,0
480196_023186_0300Acta0298.jpg,211802010.01.1.0001,61,315,2,378,0,0
480196_038048_0549Acta0421.jpg,210514015.02.1.0001,96,352,8,456,0,0
480196_046731_0660Acta0439.jpg,210506019.01.1.0001,70,343,7,420,0,0
480196_072197_0393Acta0373.jpg,210513014.05.1.0001,90,317,4,411,0,0
480196_076975_0376Acta0370.jpg,210513050.04.1.0001,119,349,6,474,0,0
480196_103578_0490Acta0406.jpg,210511008.02.1.0001,109,418,9,536,0,0
480196_151767_0183Acta0182.jpg,210202003.01.1.0001,68,206,2,276,0,0
480196_156190_0137Acta0136.jpg,210507007.04.1.0001,59,290,4,353,0,0
480196_158280_0031Acta0030.jpg,210503024.03.1.0001,133,365,6,504,0,0
480196_161988_0197Acta0196.jpg,210202004.01.1.0001,85,266,6,357,0,0
480196_188137_0302Acta0300.jpg,211802010.03.1.0001,52,281,7,340,0,0
480196_213070_0437Acta0390.jpg,211005002.01.1.0001,100,410,4,514,0,0
480196_217760_0322Acta0320.jpg,211802014.01.1.0001,52,355,7,414,0,0
480196_225988_0511Acta0413.jpg,210516012.02.1.0001,108,392,10,510,1,1
480196_240476_0058Acta0057.jpg,210503018.04.1.0001,85,342,5,432,0,0
480196_267034_0219Acta0218.jpg,210605037.01.1.0001,145,69,1,215,0,0
480196_310802_0655Acta0439.jpg,210506015.03.1.0001,54,239,4,297,0,0
480196_319748_0185Acta0184.jpg,210202001.01.1.0001,104,290,4,398,0,0
480196_330521_0142Acta0141.jpg,210507010.03.1.0001,38,307,8,353,0,0
480196_351180_0492Acta0406.jpg,210511008.04.1.0001,131,361,6,498,0,0
480196_356832_0304Acta0302.jpg,211806001.05.1.0001,119,297,5,421,0,0
480196_373193_0570Acta0426.jpg,210518006.01.1.0001,129,247,1,377,0,0
480196_378275_0474Acta0401.jpg,210511012.03.1.0001,67,302,8,377,0,0
480196_390876_0674Acta0442.jpg,210506011.01.1.0001,36,344,7,387,0,0
480196_409282_0463Acta0399.jpg,210511001.04.1.0001,81,303,1,385,0,0
480196_426935_0580Acta0427.jpg,210514005.02.1.0001,169,377,12,558,0,0
480196_432253_0436Acta0390.jpg,211005002.02.1.0001,100,420,2,522,0,0
480196_433348_0403Acta0377.jpg,211004002.03.1.0001,125,434,0,559,0,0
480196_434978_0042Acta0041.jpg,210503002.02.1.0001,64,381,6,451,0,0
480196_439136_0411Acta0381.jpg,211002002.02.1.0001,250,175,2,427,0,0
480196_440925_0466Acta0399.jpg,210511001.03.1.0001,69,307,2,378,0,0
480196_441105_0581Acta0427.jpg,210514005.03.1.0001,154,392,7,553,0,0
480196_496073_0690Acta0443.jpg,210506008.02.1.0001,52,196,1,249,0,0
480196_518977_0626Acta0436.jpg,210516002.02.1.0001,108,335,6,449,0,0
480196_526465_0224Acta0223.jpg,210605003.01.1.0001,129,279,5,413,0,0
480196_527006_0396Acta0375.jpg,210513041.01.1.0001,174,274,12,460,0,0
480196_606959_0081Acta0080.jpg,210506006.04.1.0001,81,341,7,429,0,0
480196_638765_0138Acta0137.jpg,210507007.05.1.0001,46,306,4,356,0,0
480196_660791_0489Acta0406.jpg,210511008.01.1.0001,110,394,6,510,0,0
480196_694975_0125Acta0124.jpg,210507019.02.1.0001,89,289,4,382,0,0
480196_696525_0303Acta0301.jpg,211802010.04.1.0001,57,328,11,396,0,0
480196_700940_0289Acta0287.jpg,210605006.02.1.0001,139,306,7,452,0,0
480196_706942_0512Acta0413.jpg,210516012.03.1.0001,104,366,7,477,0,0
480196_713754_0117Acta0116.jpg,211804008.01.1.0001,153,140,2,295,0,0
480196_715581_0105Acta0104.jpg,211804005.02.1.0001,114,273,4,391,0,0
480196_718417_0108Acta0107.jpg,211804001.03.1.0001,108,359,11,478,0,0
480196_752179_0652Acta0438.jpg,210506007.03.1.0001,61,307,9,377,0,0
480196_776170_0327Acta0325.jpg,211802011.01.1.0001,83,239,5,327,0,0
480196_793395_0672Acta0441.jpg,210506013.02.1.0001,33,301,3,337,0,0
480196_823261_0030Acta0029.jpg,210503024.04.1.0001,125,374,11,510,0,0
480196_823508_0262Acta0260.jpg,210603003.01.1.0001,133,317,1,451,0,0
480196_849720_0237Acta0235.jpg,210605005.02.1.0001,137,263,7,407,0,0
480196_859032_0323Acta0321.jpg,211802014.05.1.0001,59,330,3,392,0,0
480196_935686_0554Acta0422.jpg,210514020.03.1.0001,77,331,8,416,0,0
480196_943711_0591Acta0428.jpg,210203001.01.1.0001,77,300,0,377,0,0
480196_996539_0242Acta0240.jpg,210604001.02.1.0001,226,371,13,610,0,0
481317_000181_0209Acta0060.jpg,110801011.01.1.0001,319,360,33,712,0,0
481317_021027_0082Acta0026.jpg,110301004.01.1.0001,200,420,17,637,0,0
481317_127949_0206Acta0060.jpg,110801008.01.1.0001,207,109,4,320,0,0
481317_189500_0263Acta0075.jpg,110802012.01.1.0001,163,87,8,258,0,0
481317_294777_0120Acta0035.jpg,110306007.02.1.0001,149,562,18,729,0,0
481317_425303_0125Acta0036.jpg,110301007.04.1.0001,234,333,22,589,0,0
481317_481120_0121Acta0035.jpg,110306007.01.1.0001,155,543,27,725,0,0
481317_481539_0172Acta0048.jpg,110308001.03.1.0001,138,568,18,724,0,0
481317_646975_0155Acta0044.jpg,110307001.01.1.0001,95,385,9,489,0,0
481317_654516_0160Acta0045.jpg,110301003.03.1.0001,100,446,10,556,0,0
481317_844723_0083Acta0026.jpg,110301004.02.1.0001,189,398,25,612,0,0
481317_888674_0145Acta0041.jpg,110305002.01.1.0001,391,252,15,658,0,0
481317_931844_0226Acta0065.jpg,110801026.01.1.0001,114,401,13,528,0,0
488168_158562_0088Acta0088.jpg,090303003.01.1.0001,63,280,9,352,0,0
488168_204416_0105Acta0105.jpg,090901004.02.1.0001,58,292,6,356,0,0
488168_271149_0049Acta0049.jpg,091401013.01.1.0001,152,420,10,582,0,0
488168_423277_0149Acta0149.jpg,092402003.01.1.0001,100,272,2,374,0,0
488168_475720_0091Acta0091.jpg,090305001.02.1.0001,54,370,11,435,0,0
488168_634550_0046Acta0046.jpg,091401003.02.1.0001,59,464,3,526,0,0
488168_709840_0121Acta0121.jpg,090903001.01.1.0001,72,306,5,383,0,0
488168_727633_0102Acta0102.jpg,090901005.01.1.0001,76,446,2,524,0,0
488168_773673_0058Acta0058.jpg,090304006.01.1.0001,135,301,11,447,0,0
488168_834225_0029Acta0029.jpg,091401004.02.1.0001,81,383,4,468,0,0
489338_058140_0211Acta0211.jpg,040108017.01.1.0001,127,269,11,407,0,0
489338_067041_0251Acta0251.jpg,040107007.01.1.0001,144,327,18,489,0,0
489338_082455_0091Acta0091.jpg,041301007.02.1.0001,95,365,6,466,0,0
489338_148387_0057Acta0057.jpg,041301009.03.1.0001,114,357,17,488,0,0
489338_148547_0084Acta0084.jpg,041301007.07.1.0001,91,345,13,449,0,0
489338_161402_0217Acta0217.jpg,040108011.02.1.0001,177,257,30,464,0,0
489338_163096_0028Acta0028.jpg,041302022.05.1.0001,102,369,10,481,0,0
489338_205605_0242Acta0242.jpg,040107005.02.1.0001,104,362,8,474,1,1
489338_276862_0060Acta0060.jpg,041301011.01.1.0001,160,356,9,525,0,0
489338_444432_0068Acta0068.jpg,041302029.01.1.0001,134,301,15,450,0,0
489338_477423_0140Acta0140.jpg,040107001.02.1.0001,111,417,10,538,0,0
489338_528860_0253Acta0253.jpg,040107007.04.1.0001,131,368,21,520,0,0
489338_545951_0267Acta0267.jpg,041801004.03.1.0001,186,332,20,538,0,0
489338_549262_0120Acta0120.jpg,041301012.04.1.0001,110,393,12,515,0,0
489338_593440_0227Acta0227.jpg,040107005.05.1.0001,119,361,16,496,0,0
489338_629963_0230Acta0230.jpg,040107003.02.1.0001,77,272,10,359,0,0
489338_698300_0182Acta0182.jpg,040108002.02.1.0001,106,381,11,498,0,0
489338_700324_0243Acta0243.jpg,040107005.01.1.0001,122,366,7,495,0,0
489338_705558_0204Acta0204.jpg,040108007.02.1.0001,182,321,27,530,0,0
489338_746423_0063Acta0063.jpg,041301002.04.1.0001,81,329,14,424,0,0
489338_791153_0047Acta0047.jpg,041302027.01.1.0001,127,303,22,452,1,1
489338_801825_0086Acta0086.jpg,041301007.08.1.0001,64,423,10,497,0,0
489338_843800_0137Acta0137.jpg,041301015.01.1.0001,122,394,20,536,1,1
489338_849714_0245Acta0245.jpg,040107013.02.1.0001,63,351,13,427,0,0
489338_863682_0114Acta0114.jpg,041302012.01.1.0001,130,383,15,528,0,0
489338_876473_0108Acta0108.jpg,041302007.04.1.0001,125,357,9,491,0,0
489338_909362_0154Acta0154.jpg,040108014.01.1.0001,108,415,17,540,0,0
489338_910577_0018Acta0018.jpg,041302018.02.1.0001,110,420,18,548,0,0
489338_928513_0231Acta0231.jpg,040107003.01.1.0001,89,291,11,391,0,0
492227_097163_0031Acta0031.jpg,060201024.01.1.0001,59,60,2,121,0,0
492426_318468_0371Acta0148.jpg,121402001.02.1.0001,42,461,5,508,0,0
492426_403581_0364Acta0143.jpg,121401001.01.1.0001,83,494,6,583,0,0
492426_442360_0358Acta0138.jpg,121501002.02.1.0001,27,488,2,517,0,0
492426_812795_0394Acta0167.jpg,121001002.02.1.0001,96,600,10,706,0,0
492677_051266_0570Acta0150.jpg,051002001.03.1.0001,61,453,9,523,0,0
492677_092833_0428Acta0061.jpg,051001007.03.1.0001,46,378,3,427,0,0
492677_343762_0434Acta0067.jpg,051001001.04.1.0001,62,469,9,540,0,0
492677_357239_0648Acta0197.jpg,051001012.05.1.0001,52,470,7,529,0,0
492677_767050_0553Acta0141.jpg,050402001.03.1.0001,76,388,2,466,0,0
492677_891408_0495Acta0101.jpg,051001003.02.1.0001,57,528,4,589,0,0
492677_943625_0562Acta0146.jpg,050401011.01.1.0001,104,489,13,606,0,0
493518_080370_0227Acta0227.jpg,181602003.01.1.0001,57,222,4,283,0,0
493518_141120_0451Acta0451.jpg,180201016.06.1.0001,49,263,7,319,0,0
493518_154544_0378Acta0378.jpg,182601001.01.1.0001,76,220,10,306,0,0
493518_340204_0075Acta0075.jpg,180601007.03.1.0001,57,376,11,444,0,0
493518_345315_0505Acta0505.jpg,180201005.01.1.0001,94,396,4,494,0,0
493518_346699_0593Acta0593.jpg,180201001.02.1.0001,33,237,7,277,0,0
493518_427293_0173Acta0173.jpg,180602001.03.1.0001,96,421,18,535,3,3
493518_489091_0608Acta0608.jpg,180201022.01.1.0001,51,116,2,169,0,0
493518_506045_0055Acta0055.jpg,180601001.02.1.0001,55,472,6,533,0,0
493518_522840_0538Acta0538.jpg,180201010.02.1.0001,43,313,8,364,0,0
493518_566664_0456Acta0456.jpg,180201016.04.1.0001,59,268,8,335,0,0
493518_571955_0541Acta0541.jpg,180201010.01.1.0001,36,307,8,351,0,0
493518_577815_0089Acta0089.jpg,180601015.02.1.0001,40,487,6,533,0,0
493518_682383_0576Acta0576.jpg,180201003.03.1.0001,33,190,3,226,0,0
493518_699203_0531Acta0531.jpg,180201010.04.1.0001,47,293,4,344,0,0
493518_702202_0595Acta0595.jpg,180201001.01.1.0001,36,252,6,294,0,0
493518_733078_0470Acta0470.jpg,180201002.03.1.0001,42,290,5,337,0,0
493518_748885_0336Acta0336.jpg,181601002.04.1.0001,57,303,5,365,0,0
493518_781550_0134Acta0134.jpg,180602009.03.1.0001,86,339,10,435,0,0
493518_863484_0221Acta0221.jpg,181602003.03.1.0001,47,203,6,256,0,0
493518_914077_0391Acta0391.jpg,180601021.02.1.0001,62,366,4,432,0,0
493518_915380_0522Acta0522.jpg,180201023.01.1.0001,87,301,7,395,0,0
493518_940588_0494Acta0494.jpg,180201011.02.1.0001,32,168,1,201,0,0
493518_946654_0488Acta0488.jpg,180201011.04.1.0001,30,179,6,215,0,0
493518_947626_0330Acta0330.jpg,181601001.02.1.0001,64,304,9,377,0,0
493518_968075_0574Acta0574.jpg,180201003.04.1.0001,40,200,3,243,0,0
493518_978726_0476Acta0476.jpg,180201002.01.1.0001,52,325,8,385,0,0
493518_986897_0465Acta0465.jpg,180201016.01.1.0001,49,305,6,360,0,0
494985_054336_0398Acta0161.jpg,130901104.01.1.0001,135,293,23,451,0,0
494985_324347_0289Acta0053.jpg,130902007.04.1.0001,38,336,10,384,0,0
494985_360881_0337Acta0100.jpg,130905008.01.1.0001,138,222,18,378,0,0
494985_421439_0401Acta0164.jpg,130901098.02.1.0001,193,301,18,512,0,0
494985_476167_0360Acta0123.jpg,130901062.04.1.0001,155,326,17,498,0,0
494985_489134_0298Acta0062.jpg,130902014.01.1.0001,59,262,8,329,0,0
494985_520226_0377Acta0140.jpg,130902022.01.1.0001,64,282,3,349,0,0
494985_550103_0297Acta0061.jpg,130902014.02.1.0001,60,265,15,340,0,0
494985_577857_0308Acta0072.jpg,130902024.06.1.0001,39,304,5,348,0,0
494985_623633_0306Acta0070.jpg,130902013.02.1.0001,29,302,1,332,0,0
494985_651309_0294Acta0058.jpg,130902001.02.1.0001,39,340,9,388,0,0
494985_651882_0424Acta0187.jpg,130901087.04.1.0001,207,357,33,597,0,0
494985_672289_0302Acta0066.jpg,130902015.02.1.0001,50,347,7,404,0,0
494985_689616_0382Acta0145.jpg,130902022.04.1.0001,74,288,8,370,0,0
494985_727422_0353Acta0116.jpg,130902002.01.1.0001,37,332,2,371,0,0
494985_738839_0420Acta0183.jpg,130901100.02.1.0001,207,316,16,539,0,0
494985_797615_0338Acta0101.jpg,130902012.02.1.0001,36,261,5,302,0,0
494985_819320_0351Acta0114.jpg,130902002.03.1.0001,33,323,14,370,0,0
494985_825217_0368Acta0131.jpg,130902020.01.1.0001,121,299,14,434,0,0
494985_888406_0345Acta0108.jpg,130901003.08.1.0001,28,311,6,345,0,0
494985_943072_0399Acta0162.jpg,130901034.01.1.0001,104,221,8,333,0,0
494985_946501_0385Acta0148.jpg,130902022.07.1.0001,59,276,7,342,0,0
605304_109062_0594Acta0593.jpg,070601011.02.1.0001,161,295,19,475,0,0
605304_182523_0533Acta0532.jpg,070704009.01.1.0001,79,318,5,402,0,0
605304_467370_0598Acta0597.jpg,070601043.01.1.0001,133,243,8,384,0,0
605304_496238_0658Acta0657.jpg,070704005.03.1.0001,124,375,18,517,0,0
605304_582968_0537Acta0536.jpg,070704009.04.1.0001,93,318,5,416,1,1
605304_885164_0524Acta0523.jpg,070704003.02.1.0001,132,352,17,501,0,0
605304_914337_0569Acta0568.jpg,070703005.03.1.0001,78,316,15,409,0,0
605304_916423_0653Acta0652.jpg,070705018.01.1.0001,66,374,8,448,0,0
612833_025199_0063Acta0063.jpg,170302002.01.1.0001,176,349,14,539,0,0
612833_057071_0172Acta0172.jpg,170204001.01.1.0001,210,117,4,331,0,0
612833_108934_0091Acta0091.jpg,170301006.02.1.0001,201,319,19,539,2,2
612833_154659_0201Acta0201.jpg,171201001.01.1.0001,296,153,10,459,0,0
612833_168895_0299Acta0299.jpg,171302002.01.1.0001,133,82,4,219,0,0
612833_256744_0150Acta0150.jpg,170105003.02.1.0001,87,262,2,351,0,0
612833_260353_0213Acta0213.jpg,171201008.01.1.0001,266,240,3,509,0,0
612833_307914_0198Acta0198.jpg,171202003.01.1.0001,194,24,1,219,0,0
612833_328320_0174Acta0174.jpg,170203001.01.1.0001,246,280,6,532,0,0
612833_340589_0303Acta0303.jpg,170301004.02.1.0001,209,262,11,482,0,0
612833_351565_0080Acta0080.jpg,170301005.03.1.0001,203,351,9,563,0,0
612833_426218_0161Acta0161.jpg,170301001.04.1.0001,201,332,10,543,0,0
612833_458963_0056Acta0056.jpg,170301008.02.1.0001,131,320,5,456,0,0
612833_518722_0135Acta0135.jpg,170101021.01.1.0001,122,60,7,189,0,0
612833_520898_0158Acta0158.jpg,170301017.03.1.0001,209,389,10,608,0,0
612833_595995_0259Acta0259.jpg,170304004.03.1.0001,206,331,15,552,0,0
612833_671171_0262Acta0262.jpg,170304003.03.1.0001,164,356,9,529,0,0
612833_690965_0069Acta0069.jpg,170303001.02.1.0001,178,370,14,562,0,0
612833_698466_0129Acta0129.jpg,170101008.01.1.0001,162,129,4,295,0,0
612833_702111_0195Acta0195.jpg,170201007.01.1.0001,103,80,2,185,0,0
612833_724881_0290Acta0290.jpg,171302003.01.1.0001,199,92,2,293,0,0
612833_835923_0058Acta0058.jpg,170302003.01.1.0001,182,247,6,435,0,0
612833_859801_0099Acta0099.jpg,170304005.02.1.0001,231,309,14,554,0,0
612833_885659_0292Acta0292.jpg,171302007.01.1.0001,182,131,5,318,0,0
612833_904434_0140Acta0140.jpg,170101015.01.1.0001,218,179,15,412,0,0
612833_904731_0094Acta0094.jpg,170301009.02.1.0001,81,260,9,350,0,0
612833_907372_0267Acta0267.jpg,171301006.01.1.0001,98,105,2,205,0,0
612833_953003_0276Acta0276.jpg,171301017.01.1.0001,144,59,7,210,0,0
612833_958315_0057Acta0057.jpg,170301008.03.1.0001,148,338,7,493,0,0
612833_978284_0154Acta0154.jpg,170301002.03.1.0001,207,398,13,618,0,0
616478_054148_0234Acta0234.jpg,080101003.01.1.0001,189,113,6,308,0,0
616478_184432_0186Acta0186.jpg,080101002.01.1.0001,190,83,6,279,0,0
616478_207661_0215Acta0215.jpg,080502001.02.1.0001,224,212,24,460,0,0
616478_225259_0096Acta0096.jpg,080601022.04.1.0001,128,386,7,521,0,0
616478_228463_0260Acta0260.jpg,080603002.01.1.0001,130,84,4,218,0,0
616478_272313_0220Acta0220.jpg,080501001.02.1.0001,273,216,15,504,0,0
616478_442555_0090Acta0090.jpg,080601050.01.1.0001,107,229,11,347,0,0
616478_522393_0104Acta0104.jpg,080601005.02.1.0001,106,384,7,497,0,0
616478_546702_0191Acta0191.jpg,080601043.01.1.0001,182,304,10,496,1,1
616478_559684_0114Acta0114.jpg,080601009.02.1.0001,94,425,7,526,0,0
616478_590855_0103Acta0103.jpg,080601023.03.1.0001,128,403,11,542,0,0
616478_604292_0262Acta0262.jpg,080601020.01.1.0001,82,383,9,474,0,0
616478_630003_0125Acta0125.jpg,080601031.01.1.0001,333,386,13,732,0,0
616478_697074_0124Acta0124.jpg,080601020.03.1.0001,84,410,12,506,0,0
616478_775319_0214Acta0214.jpg,080502001.01.1.0001,235,181,17,433,0,0
616478_790656_0036Acta0036.jpg,080601021.01.1.0001,109,415,13,537,0,0
616478_815917_0067Acta0067.jpg,080601033.01.1.0001,335,332,20,687,0,0
616478_901394_0212Acta0212.jpg,080603001.01.1.0001,196,316,9,521,0,0
616478_973703_0205Acta0205.jpg,080602001.01.1.0001,177,234,6,417,0,0
616478_983390_0054Acta0054.jpg,080601029.01.1.0001,219,171,13,403,0,0
616478_988670_0046Acta0046.jpg,080601025.02.1.0001,81,366,17,464,0,0
618687_057892_0351Acta0199.jpg,170504003.01.1.0001,149,54,2,205,0,0
618687_113403_0434Acta0257.jpg,171003002.01.1.0001,263,169,8,440,0,0
618687_151229_0427Acta0252.jpg,170403002.01.1.0001,280,135,8,423,0,0
618687_210991_0477Acta0285.jpg,171001006.01.1.0001,336,126,5,467,0,0
618687_289388_0416Acta0249.jpg,170401019.01.1.0001,199,124,7,330,0,0
618687_290379_0362Acta0208.jpg,170501001.04.1.0001,240,211,10,461,0,0
618687_370781_0419Acta0250.jpg,170401003.01.1.0001,242,127,9,378,0,0
618687_398912_0450Acta0272.jpg,171001001.02.1.0001,210,214,11,435,0,0
618687_469231_0472Acta0283.jpg,171001003.02.1.0001,243,165,7,415,0,0
618687_548091_0383Acta0225.jpg,170501006.01.1.0001,162,40,10,212,0,0
618687_712422_0332Acta0191.jpg,170501004.01.1.0001,191,143,7,341,0,0
618687_749292_0392Acta0234.jpg,170503001.01.1.0001,234,66,8,308,0,0
618687_770446_0347Acta0196.jpg,170502002.01.1.0001,219,115,5,339,0,0
618687_777180_0446Acta0269.jpg,171001004.01.1.0001,236,180,9,425,0,0
618687_853174_0359Acta0206.jpg,170501001.03.1.0001,224,189,7,420,0,0
618687_862129_0442Acta0265.jpg,171001004.03.1.0001,260,184,5,449,0,0
618687_879129_0387Acta0229.jpg,170504002.01.1.0001,113,44,2,159,0,0
618687_891437_0437Acta0260.jpg,171001015.01.1.0001,173,35,5,213,0,0
618687_966207_0479Acta0286.jpg,171001011.01.1.0001,173,119,6,298,0,0
621754_182115_0102Acta0070.jpg,030202003.03.1.0001,168,276,8,452,0,0
621754_256446_0071Acta0039.jpg,030501001.03.1.0001,104,319,6,429,0,0
621754_382881_0097Acta0065.jpg,030202003.04.1.0001,163,273,6,442,0,0
621754_423269_0118Acta0086.jpg,030502004.01.1.0001,213,249,13,475,1,1
621754_484029_0068Acta0036.jpg,030501001.02.1.0001,86,325,13,424,0,0
626961_054236_0158Acta0158.jpg,170801010.01.1.0001,233,270,4,507,0,0
626961_238477_0122Acta0122.jpg,170801030.01.1.0001,93,44,4,141,0,0
626961_305687_0151Acta0151.jpg,171102003.02.1.0001,200,166,9,375,0,0
626961_360257_0172Acta0172.jpg,170801007.01.1.0001,376,253,12,641,0,0
626961_433967_0160Acta0160.jpg,170801010.02.1.0001,272,254,3,529,0,0
626961_548163_0194Acta0194.jpg,171102007.01.1.0001,149,167,7,323,1,1
626961_624518_0138Acta0138.jpg,171101002.02.1.0001,182,326,11,519,0,0
626961_872154_0117Acta0117.jpg,170803005.01.1.0001,269,133,16,418,0,0
629773_160397_0056Acta0056.jpg,240107001.03.1.0001,186,321,12,519,0,0
629773_573201_0008Acta0008.jpg,240101012.02.1.0001,46,424,4,474,0,0
629773_581654_0020Acta0020.jpg,240101007.02.1.0001,81,384,9,474,0,0
636635_010545_0189Acta0189.jpg,230101001.02.1.0001,112,315,10,437,0,0
636635_049328_0227Acta0227.jpg,230402004.01.1.0001,233,167,20,420,0,0
636635_124754_0193Acta0193.jpg,230101001.01.1.0001,126,329,9,464,0,0
636635_125346_0150Acta0150.jpg,230104013.01.1.0001,105,409,9,523,0,0
636635_160714_0151Acta0151.jpg,230104011.01.1.0001,212,315,14,541,0,0
636635_300546_0158Acta0158.jpg,230105006.01.1.0001,118,170,17,305,0,0
636635_396552_0028Acta0028.jpg,230105006.02.1.0001,114,159,10,283,0,0
636635_399407_0031Acta0031.jpg,230104007.01.1.0001,203,244,14,461,0,0
636635_427929_0198Acta0198.jpg,230404001.03.1.0001,188,249,8,445,0,0
636635_437864_0080Acta0080.jpg,230107003.02.1.0001,127,319,9,455,0,0
636635_597159_0166Acta0166.jpg,230108006.01.1.0001,230,14,6,250,0,0
636635_696287_0039Acta0039.jpg,230106007.01.1.0001,108,286,8,402,0,0
636635_711521_0054Acta0054.jpg,230106004.01.1.0001,139,311,12,462,0,0
636635_754951_0176Acta0176.jpg,230202001.01.1.0001,313,96,5,414,0,0
636635_764263_0139Acta0139.jpg,230103001.02.1.0001,140,287,14,441,0,0
636635_774122_0099Acta0099.jpg,230108009.01.1.0001,108,206,8,322,1,1
636635_787598_0224Acta0224.jpg,230403004.01.1.0001,180,111,13,304,1,1
636635_787694_0064Acta0064.jpg,230104001.01.1.0001,98,306,9,413,0,0
636635_797256_0071Acta0071.jpg,230105005.03.1.0001,95,292,8,395,0,0
636635_829574_0114Acta0114.jpg,230103001.03.1.0001,154,280,9,443,0,0
636635_857718_0204Acta0204.jpg,230404004.02.1.0001,183,229,16,428,0,0
636635_952658_0034Acta0034.jpg,230104008.01.1.0001,139,92,12,243,0,0
636635_966599_0144Acta0144.jpg,230107003.01.1.0001,115,344,19,478,0,0
637933_012183_0559Acta0203.jpg,010104029.02.1.0001,144,320,15,479,0,0
637933_046309_0512Acta0156.jpg,010104024.02.1.0001,162,324,21,507,0,0
637933_068555_0527Acta0171.jpg,010104022.03.1.0001,135,319,9,463,0,0
637933_122457_0484Acta0128.jpg,010111022.03.1.0001,255,223,18,496,0,0
637933_139244_0537Acta0181.jpg,010104004.02.1.0001,170,365,18,553,0,0
637933_308848_0474Acta0118.jpg,010111004.02.1.0001,172,263,20,455,0,0
637933_317859_0572Acta0216.jpg,010110079.01.1.0001,136,378,12,526,0,0
637933_499287_0459Acta0103.jpg,010111001.03.1.0001,187,297,14,498,0,0
637933_562450_0505Acta0149.jpg,010104028.03.1.0001,167,398,21,586,0,0
637933_634383_0605Acta0249.jpg,010110169.03.1.0001,137,337,13,487,0,0
637933_655805_0593Acta0237.jpg,010110024.02.1.0001,85,227,11,323,0,0
637933_664041_0579Acta0223.jpg,010110026.04.1.0001,137,357,22,516,0,0
637933_704127_0478Acta0122.jpg,010111005.01.1.0001,160,326,19,505,0,0
637933_775680_0596Acta0240.jpg,010110022.02.1.0001,150,299,15,464,0,0
637933_804928_0597Acta0241.jpg,010110022.01.1.0001,137,284,27,448,0,0
637933_825699_0515Acta0159.jpg,010104033.02.1.0001,112,277,20,409,0,0
637933_854013_0609Acta0253.jpg,010110101.02.1.0001,173,392,18,583,0,0
637933_930860_0517Acta0161.jpg,010104033.04.1.0001,146,271,17,434,0,0
637933_955041_0533Acta0177.jpg,010104046.03.1.0001,176,310,20,506,0,0
639559_038921_0127Acta0127.jpg,040304002.01.1.0001,106,352,13,471,1,1
639559_105619_0106Acta0106.jpg,040301009.02.1.0001,115,285,14,414,1,1
639559_107401_0267Acta0267.jpg,041601001.03.1.0001,162,313,13,488,0,0
639559_159316_0266Acta0266.jpg,041601001.02.1.0001,166,335,8,509,0,0
639559_165548_0231Acta0231.jpg,041101003.03.1.0001,200,363,18,581,0,0
639559_184051_0219Acta0219.jpg,040301001.02.1.0001,164,255,11,430,0,0
639559_223981_0269Acta0269.jpg,041601005.01.1.0001,219,204,17,440,0,0
639559_273555_0273Acta0273.jpg,041601006.01.1.0001,223,236,15,474,0,0
639559_362925_0271Acta0271.jpg,041601023.01.1.0001,265,331,20,616,0,0
639559_545600_0083Acta0083.jpg,040301002.01.1.0001,138,306,20,464,0,0
639559_548904_0327Acta0327.jpg,041202001.01.1.0001,192,180,10,382,0,0
639559_569152_0155Acta0155.jpg,040302002.02.1.0001,221,312,27,560,0,0
639559_571633_0137Acta0137.jpg,040301011.03.1.0001,142,331,23,496,0,0
639559_651571_0226Acta0226.jpg,041101001.02.1.0001,136,296,18,450,0,0
639559_711713_0152Acta0152.jpg,040302011.01.1.0001,218,200,20,438,0,0
639559_747285_0235Acta0235.jpg,041101006.01.1.0001,137,289,16,442,0,0
639559_778471_0206Acta0206.jpg,040301013.02.1.0001,290,271,24,585,0,0
639559_807405_0192Acta0192.jpg,040305001.04.1.0001,190,353,18,561,0,0
639559_813645_0217Acta0217.jpg,040301007.01.1.0001,109,330,11,450,0,0
639559_888796_0161Acta0161.jpg,040304005.04.1.0001,113,386,12,511,0,0
639559_930919_0091Acta0091.jpg,040301003.03.1.0001,73,360,17,450,0,0
639559_952939_0234Acta0234.jpg,041101005.03.1.0001,162,247,20,429,0,0
639559_953744_0087Acta0087.jpg,040301004.02.1.0001,84,339,6,429,0,0
639559_963303_0123Acta0123.jpg,040304001.03.1.0001,115,434,9,558,0,0
639559_994697_0200Acta0200.jpg,040304008.03.1.0001,129,402,21,552,0,0
639559_994747_0247Acta0247.jpg,041101010.03.1.0001,148,269,21,438,0,0
653421_182905_2024-07-29-0002.jpg,071301017.02.1.0001,102,461,14,577,0,0
653421_256677_2024-07-29-0002.jpg,071301006.02.1.0001,71,413,15,499,0,0
653421_445336_2024-07-29-0003.jpg,071301006.03.1.0001,48,437,15,500,0,0
653421_541435_2024-07-28-0002.jpg,071301009.02.1.0001,75,392,10,477,0,0
653421_591741_2024-07-28-0012.jpg,071301010.12.1.0001,44,458,6,508,0,0
653421_675326_2024-07-28-0006.jpg,071301007.05.1.0001,41,415,7,463,0,0
653421_854946_2024-07-29-0001.jpg,071201020.01.1.0001,149,405,20,574,0,0
653421_995765_2024-07-29-0004.jpg,071201015.04.1.0001,115,413,11,539,1,1
653905_011727_2024-07-29-0002.jpg,070203017.02.1.0001,188,308,23,519,0,0
653905_075938_2024-07-29-0001.jpg,070202001.04.1.0001,206,345,23,574,0,0
653905_245123_2024-07-29-0002.jpg,070203004.02.1.0001,138,373,29,540,0,0
653905_596718_2024-07-29-0003.jpg,070201002.02.1.0001,252,219,13,484,0,0
653905_945411_2024-07-29-0002.jpg,070201011.02.1.0001,133,236,13,382,0,0
656297_005219_0254Acta0120.jpg,131901018.02.1.0001,26,366,5,397,0,0
656297_007393_0318Acta0184.jpg,131801013.01.1.0001,46,356,7,409,0,0
656297_013794_0530Acta0396.jpg,131601007.03.1.0001,19,352,2,373,0,0
656297_016468_0264Acta0130.jpg,131901004.03.1.0001,40,393,3,436,0,0
656297_045201_0277Acta0143.jpg,131602001.01.1.0001,19,353,3,375,0,0
656297_050309_0339Acta0205.jpg,131601054.03.1.0001,22,414,3,439,0,0
656297_052667_0416Acta0282.jpg,131901003.05.1.0001,19,423,3,445,0,0
656297_053653_0712Acta0574.jpg,131601015.02.1.0001,38,349,4,391,0,0
656297_067742_0521Acta0387.jpg,131601033.01.1.0001,87,311,9,407,0,0
656297_071804_0672Acta0538.jpg,130904007.04.1.0001,232,324,27,583,0,0
656297_083716_0443Acta0309.jpg,131801001.01.1.0001,26,206,5,237,0,0
656297_085898_0802Acta0624.jpg,131601036.02.1.0001,88,357,18,463,0,0
656297_092136_0329Acta0195.jpg,131801018.01.1.0001,50,281,6,337,0,0
656297_099515_0327Acta0193.jpg,131801024.03.1.0001,51,335,7,393,0,0
656297_109862_0400Acta0266.jpg,131601019.05.1.0001,36,353,4,393,0,0
656297_111247_0623Acta0489.jpg,131801011.02.1.0001,58,338,5,401,0,0
656297_122422_0240Acta0106.jpg,131801004.03.1.0001,32,284,5,321,0,0
656297_126295_0680Acta0546.jpg,130901067.04.1.0001,175,417,29,621,0,0
656297_131795_0528Acta0394.jpg,131601007.02.1.0001,29,334,1,364,0,0
656297_136441_0476Acta0342.jpg,131801010.07.1.0001,68,368,5,441,0,0
656297_142422_0806Acta0626.jpg,131601071.02.1.0001,46,308,8,362,0,0
656297_143192_0419Acta0285.jpg,131901003.02.1.0001,20,369,6,395,1,1
656297_153481_0375Acta0241.jpg,131901010.01.1.0001,44,442,5,491,1,1
656297_171293_0898Acta0668.jpg,131601005.01.1.0001,51,335,3,389,0,0
656297_180947_0630Acta0496.jpg,131801007.01.1.0001,41,385,9,435,0,0
656297_188156_0266Acta0132.jpg,131901004.02.1.0001,27,423,8,458,0,0
656297_193907_0644Acta0510.jpg,130901111.07.1.0001,143,362,24,529,0,0
656297_205130_0369Acta0235.jpg,131602021.02.1.0001,27,313,7,347,0,0
656297_214011_0492Acta0358.jpg,131601044.03.1.0001,44,384,3,431,0,0
656297_214602_0301Acta0167.jpg,131801009.01.1.0001,40,361,9,410,0,0
656297_219127_0577Acta0443.jpg,131602005.01.1.0001,27,271,3,301,0,0
656297_230527_0859Acta0651.jpg,130901099.02.1.0001,151,358,12,521,0,0
656297_242169_0556Acta0422.jpg,131601041.04.1.0001,22,365,2,389,0,0
656297_248184_0445Acta0311.jpg,131901012.03.1.0001,92,391,13,496,0,0
656297_258142_0546Acta0412.jpg,131602011.07.1.0001,28,325,3,356,0,0
656297_262602_0713Acta0575.jpg,131601015.03.1.0001,43,363,4,410,0,0
656297_269921_0396Acta0262.jpg,131601019.02.1.0001,30,363,8,401,0,0
656297_284701_0430Acta0296.jpg,131901009.02.1.0001,67,440,16,523,0,0
656297_303643_0745Acta0594.jpg,130901103.02.1.0001,188,288,26,502,0,0
656297_304523_0566Acta0432.jpg,131601018.04.1.0001,25,298,4,327,0,0
656297_319518_0241Acta0107.jpg,131801017.03.1.0001,91,452,11,554,0,0
656297_342618_0303Acta0169.jpg,131801014.06.1.0001,30,342,7,379,0,0
656297_343133_0569Acta0435.jpg,131603001.02.1.0001,14,338,6,358,0,0
656297_354395_0271Acta0137.jpg,131601009.04.1.0001,39,306,8,353,0,0
656297_354448_0604Acta0470.jpg,131603011.02.1.0001,0,0,0,0,0,0
656297_358368_0904Acta0671.jpg,131601004.02.1.0001,48,258,9,315,0,0
656297_365878_0308Acta0174.jpg,131801014.05.1.0001,32,360,6,398,0,0
656297_366189_0788Acta0618.jpg,130901021.03.1.0001,162,344,19,525,0,0
656297_390222_0603Acta0469.jpg,131603011.01.1.0001,21,238,2,261,0,0
656297_396264_0906Acta0672.jpg,131601004.04.1.0001,50,298,11,359,0,0
656297_401990_0321Acta0187.jpg,131801013.04.1.0001,48,343,14,405,0,0
656297_404347_0741Acta0591.jpg,130901107.04.1.0001,0,0,0,0,0,0
656297_425596_0293Acta0159.jpg,131801022.03.1.0001,48,344,7,399,0,0
656297_430805_0252Acta0118.jpg,131901018.05.1.0001,27,308,4,339,0,0
656297_443262_0893Acta0666.jpg,131601003.04.1.0001,41,322,5,368,0,0
656297_459277_0658Acta0524.jpg,131601007.01.1.0001,19,336,5,360,0,0
656297_484059_0718Acta0577.jpg,131601014.02.1.0001,19,329,2,350,0,0
656297_484600_0885Acta0662.jpg,130902009.03.1.0001,46,295,12,353,0,0
656297_488833_0578Acta0444.jpg,131602005.02.1.0001,21,311,4,336,0,0
656297_509463_0649Acta0515.jpg,130901111.03.1.0001,157,346,18,521,0,0
656297_513995_0232Acta0098.jpg,131801021.07.1.0001,25,352,6,383,0,0
656297_524844_0488Acta0354.jpg,131601046.03.1.0001,41,361,2,404,0,0
656297_552429_0238Acta0104.jpg,131801004.02.1.0001,26,287,7,320,0,0
656297_563305_0386Acta0252.jpg,131602015.03.1.0001,45,319,4,368,0,0
656297_566991_0565Acta0431.jpg,131601018.03.1.0001,20,311,4,335,1,1
656297_574646_0924Acta0681.jpg,130902003.01.1.0001,74,299,9,382,0,0
656297_600099_0471Acta0337.jpg,131801010.04.1.0001,62,391,13,466,0,0
656297_610661_0362Acta0228.jpg,131602006.01.1.0001,19,263,2,284,0,0
656297_620977_0458Acta0324.jpg,131801005.02.1.0001,77,265,8,350,0,0
656297_621622_0574Acta0440.jpg,131603001.07.1.0001,25,366,6,397,0,0
656297_629757_0629Acta0495.jpg,131801007.03.1.0001,67,389,4,460,0,0
656297_632475_0409Acta0275.jpg,131602010.03.1.0001,14,352,2,368,0,0
656297_639107_0500Acta0366.jpg,131601047.02.1.0001,108,377,18,503,0,0
656297_645130_0848Acta0646.jpg,130901012.05.1.0001,152,290,16,458,0,0
656297_649327_0572Acta0438.jpg,131603001.05.1.0001,19,365,1,385,0,0
656297_650922_0322Acta0188.jpg,131801013.05.1.0001,59,338,11,408,0,0
656297_654506_0231Acta0097.jpg,131801021.06.1.0001,30,355,10,395,1,1
656297_669126_0379Acta0245.jpg,131901010.04.1.0001,46,422,7,475,0,0
656297_669330_0440Acta0306.jpg,131901016.04.1.0001,53,409,3,465,0,0
656297_672347_0783Acta0616.jpg,130901113.02.1.0001,50,325,9,384,0,0
656297_680231_0925Acta0681.jpg,130902003.02.1.0001,74,323,12,409,0,0
656297_682930_0815Acta0630.jpg,131601017.02.1.0001,43,343,5,391,0,0
656297_690330_0398Acta0264.jpg,131601019.04.1.0001,30,328,7,365,0,0
656297_698406_0866Acta0654.jpg,130901015.03.1.0001,139,296,20,455,0,0
656297_698774_0306Acta0172.jpg,131801014.01.1.0001,31,353,8,392,0,0
656297_706722_0283Acta0149.jpg,131601008.03.1.0001,26,323,6,355,0,0
656297_717457_0540Acta0406.jpg,131602011.02.1.0001,28,393,5,426,0,0
656297_724337_0403Acta0269.jpg,131601019.06.1.0001,35,349,8,392,0,0
656297_731978_0571Acta0437.jpg,131603001.04.1.0001,20,380,6,406,0,0
656297_738737_0388Acta0254.jpg,131602016.03.1.0001,28,402,8,438,0,0
656297_746626_0876Acta0659.jpg,130901044.02.1.0001,27,358,1,386,0,0
656297_751480_0620Acta0486.jpg,131801008.05.1.0001,58,310,6,374,0,0
656297_755141_0923Acta0680.jpg,130901018.03.1.0001,97,326,11,434,0,0
656297_767874_0246Acta0112.jpg,131901011.05.1.0001,21,477,3,501,0,0
656297_771030_0874Acta0658.jpg,130901019.01.1.0001,130,228,14,372,0,0
656297_781286_0568Acta0434.jpg,131603001.01.1.0001,24,332,4,360,0,0
656297_783340_0721Acta0579.jpg,131601002.01.1.0001,36,275,8,319,0,0
656297_785221_0738Acta0589.jpg,130901073.02.1.0001,155,250,17,422,0,0
656297_795094_0899Acta0668.jpg,131601005.02.1.0001,52,323,13,388,0,0
656297_810946_0823Acta0633.jpg,130901036.02.1.0001,26,236,7,269,0,0
656297_813066_0728Acta0582.jpg,131601002.08.1.0001,30,377,11,418,0,0
656297_813127_0617Acta0483.jpg,131801008.02.1.0001,70,295,10,375,0,0
656297_822184_0504Acta0370.jpg,131601025.01.1.0001,23,329,5,357,0,0
656297_825724_0395Acta0261.jpg,131601019.01.1.0001,37,366,5,408,0,0
656297_827638_0279Acta0145.jpg,131602001.03.1.0001,12,373,4,389,0,0
656297_831405_0905Acta0672.jpg,131601004.03.1.0001,38,305,8,351,0,0
656297_859470_0451Acta0317.jpg,131901001.01.1.0001,22,389,8,419,0,0
656297_860743_0352Acta0218.jpg,131601027.04.1.0001,29,298,9,336,0,0
656297_863439_0383Acta0249.jpg,131602015.04.1.0001,49,353,9,411,0,0
656297_877780_0309Acta0175.jpg,131801014.02.1.0001,42,347,4,393,0,0
656297_891534_0289Acta0155.jpg,131801022.05.1.0001,41,316,3,360,0,0
656297_893600_0719Acta0578.jpg,131601014.03.1.0001,21,327,2,350,0,0
656297_907278_0835Acta0639.jpg,130901056.02.1.0001,125,240,23,388,0,0
656297_928458_0253Acta0119.jpg,131901018.01.1.0001,24,322,2,348,0,0
656297_936046_0601Acta0467.jpg,131603007.02.1.0001,131,303,11,445,1,1
656297_937010_0234Acta0100.jpg,131801021.10.1.0001,28,319,11,358,0,0
656297_946525_0393Acta0259.jpg,131601021.03.1.0001,25,314,7,346,0,0
656297_947853_0879Acta0660.jpg,130901044.05.1.0001,34,366,6,406,0,0
656297_950861_0427Acta0293.jpg,131901002.03.1.0001,58,346,7,411,0,0
656297_977650_0567Acta0433.jpg,131601018.05.1.0001,31,360,5,396,0,0
656297_979785_0584Acta0450.jpg,131603006.04.1.0001,77,422,17,516,0,0
656297_984900_0337Acta0203.jpg,131601054.05.1.0001,31,404,4,439,0,0
662379_001563_0281Acta0281.jpg,090404006.03.1.0001,123,357,17,497,0,0
662379_009458_0087Acta0087.jpg,090402004.01.1.0001,94,435,15,544,0,0
662379_027202_0098Acta0098.jpg,090402005.03.1.0001,57,313,15,385,0,0
662379_034127_0090Acta0090.jpg,090402004.03.1.0001,111,423,12,546,0,0
662379_038803_0061Acta0061.jpg,090402010.01.1.0001,127,380,16,523,0,0
662379_055939_0309Acta0309.jpg,090402017.05.1.0001,101,440,17,558,0,0
662379_192484_0278Acta0278.jpg,090404003.01.1.0001,74,85,2,161,0,0
662379_192898_0066Acta0066.jpg,090402021.01.1.0001,68,294,8,370,0,0
662379_197624_0144Acta0144.jpg,090403005.04.1.0001,31,262,8,301,0,0
662379_202665_0067Acta0067.jpg,090402016.02.1.0001,64,241,11,316,0,0
662379_237436_0198Acta0198.jpg,090401006.01.1.0001,90,395,11,496,0,0
662379_251857_0118Acta0118.jpg,090401007.05.1.0001,96,418,23,537,0,0
662379_282507_0134Acta0134.jpg,090403011.02.1.0001,58,378,6,442,0,0
662379_290683_0308Acta0308.jpg,090402017.04.1.0001,85,417,19,521,0,0
662379_305609_0306Acta0306.jpg,090402017.02.1.0001,94,401,14,509,0,0
662379_322581_0284Acta0284.jpg,090404010.01.1.0001,153,350,18,521,0,0
662379_335124_0143Acta0143.jpg,090403005.02.1.0001,34,353,8,395,0,0
662379_361874_0135Acta0135.jpg,090403011.05.1.0001,65,369,8,442,0,0
662379_422893_0247Acta0247.jpg,091602001.05.1.0001,63,375,7,445,0,0
662379_436023_0102Acta0102.jpg,090402024.02.1.0001,73,333,11,417,1,1
662379_466085_0137Acta0137.jpg,090403011.01.1.0001,54,365,5,424,0,0
662379_544803_0202Acta0202.jpg,090401023.01.1.0001,154,408,25,587,0,0
662379_602684_0146Acta0146.jpg,090403005.03.1.0001,29,292,3,324,0,0
662379_662370_0154Acta0154.jpg,090403014.03.1.0001,90,434,12,536,0,0
662379_691463_0101Acta0101.jpg,090402024.01.1.0001,78,346,15,439,0,0
662379_693999_0205Acta0205.jpg,090401009.01.1.0001,91,424,8,523,0,0
662379_695239_0043Acta0043.jpg,090402007.01.1.0001,95,360,12,467,0,0
662379_871824_0243Acta0243.jpg,091602001.01.1.0001,59,319,6,384,0,0
662379_872422_0257Acta0257.jpg,091601005.02.1.0001,92,289,7,388,0,0
662379_946209_0062Acta0062.jpg,090402010.02.1.0001,139,350,21,510,0,0
667154_078945_0066Acta0054.jpg,100501017.01.1.0001,85,78,1,164,0,0
667154_545710_0093Acta0077.jpg,100701002.03.1.0001,110,425,9,544,1,1
667154_582604_0035Acta0026.jpg,100501001.01.1.0001,132,420,15,567,0,0
667154_745062_0068Acta0056.jpg,100501005.01.1.0001,60,59,0,119,0,0
667154_753232_0091Acta0075.jpg,100701002.01.1.0001,105,422,11,538,0,0
667154_822118_0089Acta0073.jpg,100701001.01.1.0001,151,429,15,595,0,0
667448_000528_0324Acta0324.jpg,211805020.02.1.0001,126,254,10,390,0,0
667448_014898_0109Acta0109.jpg,211803033.05.1.0001,79,340,5,424,0,0
667448_079198_0166Acta0166.jpg,211802003.01.1.0001,86,321,6,413,0,0
667448_093744_0224Acta0224.jpg,211807002.03.1.0001,74,301,10,385,0,0
667448_119869_0298Acta0298.jpg,211805024.02.1.0001,125,322,6,453,0,0
667448_133095_0138Acta0138.jpg,211803025.02.1.0001,110,281,7,398,0,0
667448_146124_0155Acta0155.jpg,211803019.03.1.0001,94,352,3,449,1,1
667448_175560_0173Acta0173.jpg,211802007.02.1.0001,94,242,4,340,0,0
667448_209125_0293Acta0293.jpg,211805022.01.1.0001,103,290,4,397,0,0
667448_229905_0309Acta0309.jpg,211805009.06.1.0001,79,337,5,421,0,0
667448_248298_0178Acta0178.jpg,211803012.02.1.0001,71,303,4,378,0,0
667448_250837_0149Acta0149.jpg,211803020.04.1.0001,45,297,3,345,0,0
667448_348597_0169Acta0169.jpg,211802003.03.1.0001,81,320,7,408,0,0
667448_397282_0158Acta0158.jpg,211802005.01.1.0001,98,333,12,443,0,0
667448_403320_0270Acta0270.jpg,211801001.04.1.0001,116,346,6,468,0,0
667448_404306_0117Acta0117.jpg,211803034.01.1.0001,133,331,7,471,0,0
667448_491673_0236Acta0236.jpg,211807005.02.1.0001,125,264,7,396,0,0
667448_522300_0195Acta0195.jpg,211803013.04.1.0001,68,298,4,370,0,0
667448_522301_0108Acta0108.jpg,211803033.01.1.0001,59,350,2,411,0,0
667448_688394_0312Acta0312.jpg,211805016.02.1.0001,113,289,11,413,0,0
667448_857525_0129Acta0129.jpg,211803006.01.1.0001,33,301,3,337,0,0
667448_878610_0308Acta0308.jpg,211805009.05.1.0001,86,365,7,458,0,0
667448_977629_0185Acta0185.jpg,211803011.03.1.0001,98,348,6,452,0,0
669215_373506_2024-07-29-0003.jpg,120813009.03.1.0001,94,368,2,464,0,0
669215_376153_2024-07-29-0002.jpg,120406001.02.1.0001,69,397,14,480,1,1
669215_582197_2024-07-29-0001.jpg,120402001.01.1.0001,114,454,11,579,0,0
669215_686054_2024-07-29-0003.jpg,120406001.03.1.0001,60,416,9,485,0,0
669215_774595_2024-07-29-0001.jpg,120405010.01.1.0001,93,221,11,325,0,0
669215_954302_2024-07-29-0004.jpg,120407004.03.1.0001,98,440,5,543,0,0
669283_017721_0034Acta0034.jpg,030403010.01.1.0001,234,316,9,559,0,0
669283_284939_0018Acta0018.jpg,030401002.01.1.0001,47,202,0,249,0,0
669283_566216_0024Acta0024.jpg,030403001.03.1.0001,140,229,7,376,0,0
669283_751651_0026Acta0026.jpg,030403001.01.1.0001,126,248,8,382,0,0
670988_029528_0273Acta0231.jpg,131102003.01.1.0001,256,170,33,459,0,0
670988_183145_0277Acta0235.jpg,131102001.03.1.0001,125,382,13,520,1,1
670988_246232_0121Acta0080.jpg,130801017.03.1.0001,166,341,14,521,0,0
670988_335438_0099Acta0058.jpg,130801006.10.1.0001,64,364,7,435,0,0
670988_343277_0127Acta0086.jpg,131101003.01.1.0001,238,298,16,552,0,0
670988_355263_0152Acta0111.jpg,131101032.04.1.0001,98,349,18,465,0,0
670988_380287_0226Acta0184.jpg,131101004.02.1.0001,219,293,22,534,0,0
670988_445661_0165Acta0124.jpg,131101031.05.1.0001,84,386,11,481,0,0
670988_478495_0172Acta0131.jpg,131101026.04.1.0001,91,365,10,466,0,0
670988_560613_0160Acta0119.jpg,131101014.03.1.0001,235,368,25,628,0,0
670988_563409_0248Acta0206.jpg,131101025.04.1.0001,91,386,10,487,0,0
670988_591015_0194Acta0153.jpg,131101010.02.1.0001,159,355,16,530,0,0
670988_624641_0233Acta0191.jpg,131101016.06.1.0001,77,432,10,519,0,0
670988_644074_0215Acta0173.jpg,131101008.02.1.0001,77,235,11,323,0,0
670988_755634_0175Acta0134.jpg,131101026.01.1.0001,101,414,7,522,0,0
670988_767530_0192Acta0151.jpg,131101010.04.1.0001,150,349,12,511,0,0
670988_891284_0145Acta0104.jpg,131101035.01.1.0001,149,448,10,607,0,0
670988_895698_0120Acta0079.jpg,131102012.01.1.0001,301,98,16,415,0,0
670988_916389_0091Acta0050.jpg,130801006.07.1.0001,70,445,7,522,0,0
670988_968749_0236Acta0194.jpg,131101017.01.1.0001,72,411,4,487,0,0
673056_051879_0543Acta0260.jpg,170902012.01.1.0001,194,224,5,423,0,0
673056_065262_0579Acta0296.jpg,170904013.04.1.0001,183,361,10,554,0,0
673056_069244_0398Acta0119.jpg,170901014.04.1.0001,158,375,12,545,0,0
673056_073384_0592Acta0309.jpg,170904006.01.1.0001,121,417,11,549,0,0
673056_099983_0607Acta0324.jpg,170904012.03.1.0001,215,318,20,553,0,0
673056_130450_0487Acta0204.jpg,170903037.01.1.0001,210,195,13,418,0,0
673056_203463_0606Acta0323.jpg,170904012.02.1.0001,227,318,17,562,1,1
673056_241586_0391Acta0112.jpg,170901015.03.1.0001,145,294,14,453,0,0
673056_395584_0726Acta0443.jpg,170906001.02.1.0001,173,366,20,559,0,0
673056_414711_0564Acta0281.jpg,170902009.04.1.0001,260,256,21,537,0,0
673056_442291_0400Acta0121.jpg,170901055.02.1.0001,217,291,26,534,0,0
673056_510277_0733Acta0450.jpg,170906004.01.1.0001,251,397,37,685,0,0
673056_534367_0712Acta0429.jpg,170907004.02.1.0001,231,275,17,523,0,0
673056_554025_0560Acta0277.jpg,170902007.03.1.0001,151,264,8,423,0,0
673056_577691_0532Acta0249.jpg,170903010.03.1.0001,225,323,9,557,0,0
673056_590277_0646Acta0363.jpg,170901004.02.1.0001,159,227,12,398,0,0
673056_606535_0512Acta0229.jpg,170903007.02.1.0001,250,362,19,631,0,0
673056_620435_0706Acta0423.jpg,170907009.01.1.0001,184,103,9,296,0,0
673056_624132_0588Acta0305.jpg,170904007.03.1.0001,70,371,7,448,0,0
673056_675428_0716Acta0433.jpg,170907002.03.1.0001,199,268,17,484,0,0
673056_690191_0478Acta0195.jpg,170901024.02.1.0001,172,231,17,420,0,0
673056_695460_0615Acta0332.jpg,170905012.01.1.0001,119,107,6,232,0,0
673056_719417_0530Acta0247.jpg,170903010.01.1.0001,229,336,16,581,0,0
673056_758517_0555Acta0272.jpg,170902008.01.1.0001,164,305,15,484,0,0
673056_774103_0541Acta0258.jpg,170902013.02.1.0001,197,189,10,396,0,0
673056_808672_0605Acta0322.jpg,170904012.01.1.0001,218,303,15,536,0,0
673056_831442_0584Acta0301.jpg,170904003.02.1.0001,75,294,5,374,0,0
673056_882471_0399Acta0120.jpg,170901055.01.1.0001,187,312,15,514,0,0
673056_911998_0380Acta0101.jpg,170901029.02.1.0001,155,239,18,412,0,0
673056_915612_0556Acta0273.jpg,170902008.02.1.0001,185,318,9,512,0,0
673808_027289_0336Acta0175.jpg,182201001.01.1.0001,55,472,10,537,0,0
673808_109687_0272Acta0125.jpg,180502004.01.1.0001,16,81,3,100,0,0
673808_174711_0233Acta0093.jpg,180501016.01.1.0001,82,412,7,501,0,0
673808_287235_0438Acta0259.jpg,182401001.01.1.0001,60,362,12,434,0,0
673808_298541_0294Acta0144.jpg,180501015.01.1.0001,113,556,9,678,0,0
673808_320921_0339Acta0176.jpg,182201008.01.1.0001,12,141,0,153,0,0
673808_341368_0315Acta0159.jpg,182701001.01.1.0001,71,479,11,561,0,0
673808_430470_0302Acta0149.jpg,180501004.02.1.0001,70,457,5,532,0,0
673808_490454_0301Acta0149.jpg,180501004.01.1.0001,56,503,7,566,0,0
673808_802638_0252Acta0109.jpg,180501005.01.1.0001,112,579,16,707,0,0
673808_897723_0432Acta0257.jpg,182401008.01.1.0001,70,381,7,458,0,0
673808_928150_0418Acta0247.jpg,181702001.01.1.0001,121,326,8,455,0,0
673808_965981_0265Acta0119.jpg,180501017.01.1.0001,82,453,2,537,0,0
676442_045744_0043Acta0043.jpg,211102005.02.1.0001,64,308,6,378,0,0
676442_063997_0263Acta0263.jpg,210102009.01.1.0001,173,186,7,366,0,0
676442_078283_0161Acta0161.jpg,211103004.01.1.0001,95,370,7,472,0,0
676442_114934_0125Acta0125.jpg,211102013.04.1.0001,92,432,9,533,0,0
676442_184281_0186Acta0186.jpg,212102001.01.1.0001,70,362,9,441,0,0
676442_189255_0332Acta0331.jpg,210101007.01.1.0001,156,205,5,366,0,0
676442_234407_0068Acta0068.jpg,211102020.02.1.0001,68,327,7,402,0,0
676442_285846_0324Acta0323.jpg,210105001.03.1.0001,146,391,4,541,0,0
676442_305877_0345Acta0344.jpg,211105009.03.1.0001,103,288,13,404,0,0
676442_381054_0174Acta0174.jpg,211105003.05.1.0001,111,383,10,504,0,0
676442_440106_0205Acta0205.jpg,211503007.01.1.0001,190,142,5,337,0,0
676442_447322_0099Acta0099.jpg,211102002.03.1.0001,59,322,9,390,0,0
676442_501626_0055Acta0055.jpg,211106008.03.1.0001,188,324,15,527,0,0
676442_508024_0153Acta0153.jpg,211103007.02.1.0001,91,311,8,410,0,0
676442_519575_0292Acta0291.jpg,210106008.01.1.0001,138,341,11,490,0,0
676442_521486_0296Acta0295.jpg,210106004.01.1.0001,183,278,5,466,0,0
676442_525160_0196Acta0196.jpg,212101003.01.1.0001,189,308,13,510,0,0
676442_557130_0071Acta0071.jpg,211102020.05.1.0001,73,342,6,421,0,0
676442_573964_0169Acta0169.jpg,211105002.03.1.0001,55,281,7,343,0,0
676442_581305_0329Acta0328.jpg,210101009.01.1.0001,248,278,2,528,0,0
676442_593123_0318Acta0317.jpg,210106001.02.1.0001,174,379,11,564,0,0
676442_597043_0254Acta0254.jpg,211502006.02.1.0001,88,347,14,449,0,0
676442_597364_0136Acta0136.jpg,211102014.01.1.0001,69,363,7,439,0,0
676442_611431_0240Acta0240.jpg,211502003.01.1.0001,113,320,9,442,0,0
676442_661138_0325Acta0324.jpg,210105001.02.1.0001,156,371,6,533,0,0
676442_686231_0341Acta0340.jpg,210104003.02.1.0001,143,170,2,315,0,0
676442_689070_0076Acta0076.jpg,211103002.01.1.0001,59,308,7,374,0,0
676442_712806_0204Acta0204.jpg,211502012.01.1.0001,118,201,8,327,0,0
676442_781427_0080Acta0080.jpg,211103015.02.1.0001,88,283,13,384,0,0
676442_792495_0059Acta0059.jpg,211106008.05.1.0001,215,332,10,557,0,0
676442_810752_0228Acta0228.jpg,211501005.02.1.0001,139,445,12,596,0,0
676442_816838_0106Acta0106.jpg,211105006.04.1.0001,55,256,5,316,0,0
676442_844270_0224Acta0224.jpg,211502004.01.1.0001,45,334,3,382,0,0
676442_867306_0215Acta0215.jpg,211502013.03.1.0001,84,296,6,386,0,0
676442_917300_0086Acta0086.jpg,211106002.01.1.0001,93,313,14,420,0,0
676442_931716_0315Acta0314.jpg,210103001.02.1.0001,76,504,7,587,0,0
676442_932909_0100Acta0100.jpg,211102002.04.1.0001,65,325,13,403,0,0
676839_053623_0214Acta0214.jpg,210509004.04.1.0001,120,290,9,419,0,0
676839_058142_0193Acta0193.jpg,210504009.04.1.0001,68,327,6,401,0,0
676839_060164_0117Acta0117.jpg,210502015.02.1.0001,109,425,7,541,0,0
676839_086231_0289Acta0289.jpg,210511002.02.1.0001,58,329,4,391,0,0
676839_097238_0386Acta0386.jpg,210508010.01.1.0001,39,311,5,355,0,0
676839_097513_0205Acta0205.jpg,210504020.01.1.0001,59,278,2,339,0,0
676839_123611_0463Acta0463.jpg,210501002.01.1.0001,76,407,5,488,0,0
676839_186788_0150Acta0150.jpg,210502023.01.1.0001,286,342,11,639,0,0
676839_198538_0210Acta0210.jpg,210504012.07.1.0001,41,298,4,343,0,0
676839_202638_0077Acta0077.jpg,210509016.01.1.0001,169,315,3,487,0,0
676839_204314_0207Acta0207.jpg,210504020.03.1.0001,40,288,2,330,0,0
676839_225576_0367Acta0367.jpg,210508003.02.1.0001,81,364,3,448,1,1
676839_227021_0373Acta0373.jpg,210508026.04.1.0001,80,282,4,366,0,0
676839_228894_0152Acta0152.jpg,210502016.01.1.0001,108,277,9,394,0,0
676839_252864_0261Acta0261.jpg,210505005.01.1.0001,81,323,4,408,0,0
676839_255077_0270Acta0270.jpg,210513009.03.1.0001,49,316,2,367,0,0
676839_286331_0123Acta0123.jpg,210502001.04.1.0001,169,249,5,423,0,0
676839_302820_0366Acta0366.jpg,210508003.01.1.0001,62,376,5,443,0,0
676839_325014_0648Acta0555.jpg,210506004.02.1.0001,34,285,3,322,0,0
676839_332263_0072Acta0072.jpg,210509033.02.1.0001,101,158,8,267,0,0
676839_341263_0181Acta0181.jpg,210504007.04.1.0001,59,369,2,430,0,0
676839_433854_0612Acta0541.jpg,210514006.02.1.0001,105,420,7,532,0,0
676839_436200_0377Acta0377.jpg,210508007.02.1.0001,64,293,2,359,0,0
676839_456529_0084Acta0084.jpg,210502004.02.1.0001,34,239,5,278,0,0
676839_457436_0582Acta0522.jpg,211805001.03.1.0001,78,323,13,414,0,0
676839_464850_0334Acta0334.jpg,210518002.02.1.0001,112,296,6,414,0,0
676839_505276_0553Acta0510.jpg,210513016.04.1.0001,74,317,6,397,0,0
676839_513847_0460Acta0460.jpg,210501002.04.1.0001,70,390,6,466,0,0
676839_521011_0348Acta0348.jpg,210508006.02.1.0001,43,314,4,361,0,0
676839_528065_0184Acta0184.jpg,210504006.03.1.0001,81,386,5,472,0,0
676839_540206_0370Acta0370.jpg,210508026.01.1.0001,55,276,2,333,0,0
676839_551586_0467Acta0467.jpg,211806018.02.1.0001,283,193,10,486,0,0
676839_566377_0089Acta0089.jpg,210502002.02.1.0001,55,312,8,375,0,0
676839_576516_0442Acta0442.jpg,210505003.01.1.0001,117,379,5,501,0,0
676839_577803_0528Acta0504.jpg,210513052.01.1.0001,135,336,4,475,0,0
676839_579695_0054Acta0054.jpg,210503004.01.1.0001,114,363,4,481,0,0
676839_604788_0534Acta0505.jpg,210513010.06.1.0001,95,335,4,434,0,0
676839_635650_0085Acta0085.jpg,210502004.01.1.0001,68,210,0,278,0,0
676839_637662_0372Acta0372.jpg,210508026.03.1.0001,82,303,11,396,0,0
676839_639735_0113Acta0113.jpg,210502019.04.1.0001,136,365,4,505,0,0
676839_653046_0487Acta0487.jpg,210509002.03.1.0001,118,252,5,375,0,0
676839_659992_0603Acta0538.jpg,210514002.01.1.0001,90,266,4,360,0,0
676839_695664_0561Acta0515.jpg,211805012.06.1.0001,98,344,12,454,0,0
676839_707533_0640Acta0553.jpg,210506001.02.1.0001,20,285,0,305,0,0
676839_743470_0108Acta0108.jpg,210502008.01.1.0001,20,308,1,329,0,0
676839_745430_0645Acta0553.jpg,210506001.07.1.0001,34,307,2,343,0,0
676839_746933_0206Acta0206.jpg,210504020.02.1.0001,46,282,3,331,0,0
676839_759222_0195Acta0195.jpg,210504004.02.1.0001,109,393,11,513,0,0
676839_765373_0543Acta0508.jpg,210513029.04.1.0001,96,264,7,367,1,1
676839_781106_0392Acta0392.jpg,211805010.03.1.0001,80,321,17,418,0,0
676839_787395_0447Acta0447.jpg,210501010.01.1.0001,95,350,6,451,0,0
676839_808129_0350Acta0350.jpg,210508006.01.1.0001,23,284,7,314,0,0
676839_808236_0427Acta0427.jpg,210505007.03.1.0001,81,417,3,501,0,0
676839_820580_0417Acta0417.jpg,210505012.03.1.0001,38,285,3,326,0,0
676839_823847_0378Acta0378.jpg,210508023.03.1.0001,49,264,6,319,0,0
676839_874947_0236Acta0236.jpg,210514007.02.1.0001,84,333,9,426,0,0
676839_875307_0163Acta0163.jpg,210504015.01.1.0001,67,206,2,275,0,0
676839_877896_0028Acta0028.jpg,210517002.04.1.0001,143,237,8,388,0,0
676839_964593_0151Acta0151.jpg,210502023.02.1.0001,327,334,20,681,0,0
676839_971442_0349Acta0349.jpg,210508006.04.1.0001,35,312,5,352,0,0
676839_993380_0036Acta0036.jpg,210503019.02.1.0001,74,383,7,464,0,0
677437_004484_0081Acta0081.jpg,190504002.03.1.0001,202,389,13,604,0,0
677437_041260_0306Acta0305.jpg,190303019.01.1.0001,61,27,2,90,0,0
677437_074275_0166Acta0166.jpg,191201003.03.1.0001,138,397,13,548,0,0
677437_101430_0152Acta0152.jpg,191202005.01.1.0001,114,59,2,175,0,0
677437_138824_0317Acta0316.jpg,190303002.01.1.0001,146,307,9,462,0,0
677437_160343_0290Acta0289.jpg,190302008.01.1.0001,66,87,2,155,0,0
677437_163774_0043Acta0043.jpg,190505002.01.1.0001,144,270,6,420,0,0
677437_167252_0257Acta0256.jpg,190801004.01.1.0001,52,38,1,91,0,0
677437_213769_0181Acta0181.jpg,191203005.01.1.0001,143,171,5,319,0,0
677437_220241_0176Acta0176.jpg,191701001.02.1.0001,184,403,7,594,0,0
677437_223331_0190Acta0190.jpg,191203001.04.1.0001,179,396,9,584,0,0
677437_437272_0270Acta0269.jpg,190301007.01.1.0001,25,63,1,89,0,0
677437_472951_0226Acta0225.jpg,191204003.01.1.0001,232,295,9,536,0,0
677437_496813_0110Acta0110.jpg,192003001.01.1.0001,217,358,9,584,0,0
677437_691233_0061Acta0061.jpg,190505001.01.1.0001,122,303,3,428,0,0
677437_704888_0036Acta0036.jpg,190501006.02.1.0001,150,382,5,537,0,0
677437_749393_0092Acta0092.jpg,190501001.02.1.0001,141,334,8,483,1,1
677437_761127_0083Acta0083.jpg,190504002.01.1.0001,236,372,20,628,0,0
677437_769733_0085Acta0085.jpg,190504001.02.1.0001,126,389,8,523,0,0
684534_049292_0056Acta0056.jpg,020501001.02.1.0001,182,267,4,453,0,0
684534_064039_0097Acta0097.jpg,021103001.02.1.0001,205,254,8,467,0,0
684534_206220_0144Acta0144.jpg,020403002.01.1.0001,192,296,9,497,0,0
684534_211019_0129Acta0129.jpg,021601001.01.1.0001,179,346,7,532,0,0
684534_232968_0102Acta0102.jpg,021601010.01.1.0001,192,380,9,581,0,0
684534_299371_0135Acta0135.jpg,020402002.02.1.0001,171,303,18,492,0,0
684534_433520_0072Acta0072.jpg,020401001.01.1.0001,124,281,9,414,0,0
684534_483293_0027Acta0027.jpg,021101001.03.1.0001,132,303,13,448,0,0
684534_486784_0074Acta0074.jpg,020401001.02.1.0001,117,272,10,399,0,0
684534_637903_0136Acta0136.jpg,020402002.03.1.0001,178,315,7,500,0,0
684534_648145_0059Acta0059.jpg,020502001.02.1.0001,286,276,1,563,0,0
684534_686742_0114Acta0114.jpg,021601005.02.1.0001,220,308,10,538,0,0
684534_763584_0137Acta0137.jpg,020402002.04.1.0001,195,303,12,510,0,0
684534_838688_0134Acta0134.jpg,020402002.01.1.0001,204,286,15,505,0,0
684534_914227_0077Acta0077.jpg,020401002.03.1.0001,182,388,9,579,0,0
684534_991669_0145Acta0145.jpg,020403002.02.1.0001,197,285,7,489,0,0
684967_007659_0090Acta0089.jpg,210803015.01.1.0001,77,377,7,461,0,0
684967_011434_0224Acta0223.jpg,211303009.02.1.0001,45,270,6,321,1,1
684967_099526_0280Acta0279.jpg,211302003.01.1.0001,65,203,0,268,0,0
684967_203861_0237Acta0236.jpg,211303007.05.1.0001,51,362,1,414,0,0
684967_209459_0169Acta0168.jpg,210802001.03.1.0001,88,309,3,400,0,0
684967_321967_0123Acta0122.jpg,210803014.03.1.0001,66,335,10,411,0,0
684967_481345_0147Acta0146.jpg,210803016.01.1.0001,95,367,5,467,2,2
684967_489506_0122Acta0121.jpg,210803014.04.1.0001,85,350,5,440,0,0
684967_516167_0177Acta0176.jpg,210801001.04.1.0001,70,309,4,383,0,0
684967_604199_0126Acta0125.jpg,210803011.03.1.0001,116,390,6,512,0,0
684967_626766_0091Acta0090.jpg,210803015.02.1.0001,75,374,8,457,0,0
684967_780329_0255Acta0254.jpg,211303001.05.1.0001,38,366,2,406,0,0
684967_801302_0286Acta0285.jpg,211302002.01.1.0001,155,135,0,290,0,0
691452_093286_0130Acta0055.jpg,122001004.01.1.0001,86,280,1,367,0,0
691452_271668_0259Acta0129.jpg,210906001.01.1.0001,181,316,6,503,0,0
691452_410073_0115Acta0044.jpg,122001003.01.1.0001,160,407,8,575,0,0
691452_461025_0186Acta0087.jpg,120701001.02.1.0001,190,358,10,558,0,0
691452_506912_0173Acta0077.jpg,121301002.04.1.0001,92,415,5,512,0,0
691452_584506_0179Acta0082.jpg,121301001.02.1.0001,103,479,5,587,0,0
691452_658103_0124Acta0051.jpg,121301008.02.1.0001,119,243,7,369,0,0
691452_911418_0139Acta0058.jpg,120601001.01.1.0001,134,395,10,539,0,0
691452_918512_0147Acta0063.jpg,120601011.01.1.0001,141,331,3,475,0,0
697380_085033_0240Acta0240.jpg,180901003.01.1.0001,55,408,6,469,0,0
697380_226589_0166Acta0166.jpg,181901002.01.1.0001,150,398,15,563,0,0
697380_494382_0146Acta0146.jpg,181901007.02.1.0001,60,396,7,463,0,0
697380_596726_0195Acta0195.jpg,181403001.03.1.0001,61,347,7,415,0,0
697380_773446_0135Acta0135.jpg,181901001.01.1.0001,59,439,4,502,0,0
703576_044878_0133Acta0131.jpg,040601001.01.1.0001,258,356,23,637,0,0
703576_060835_0103Acta0101.jpg,040601013.02.1.0001,150,378,13,541,0,0
703576_197340_0140Acta0138.jpg,040601009.05.1.0001,115,398,17,530,0,0
703576_276351_0131Acta0129.jpg,040601033.02.1.0001,229,325,15,569,0,0
703576_363749_0130Acta0128.jpg,040601033.01.1.0001,223,328,16,567,0,0
703576_365836_0128Acta0126.jpg,040601031.02.1.0001,134,320,12,466,0,0
703576_509648_0143Acta0141.jpg,040602001.01.1.0001,147,363,19,529,0,0
703576_637242_0137Acta0135.jpg,040601009.02.1.0001,89,374,10,473,0,0
703576_671408_0111Acta0109.jpg,040601018.01.1.0001,153,338,16,507,0,0
703576_773976_0068Acta0066.jpg,040601016.03.1.0001,64,410,9,483,0,0
703576_906786_0093Acta0091.jpg,040601014.02.1.0001,110,362,10,482,0,0
703576_915640_0124Acta0122.jpg,040601025.03.1.0001,236,376,13,625,0,0
703576_936059_0101Acta0099.jpg,040601010.03.1.0001,132,368,14,514,0,0
703576_965295_0082Acta0080.jpg,040601003.01.1.0001,135,366,13,514,0,0
706419_080987_0195Acta0195.jpg,040801004.02.1.0001,147,321,24,492,0,0
706419_097190_0186Acta0186.jpg,040802003.03.1.0001,210,358,33,601,0,0
706419_441316_0134Acta0134.jpg,040801001.02.1.0001,159,387,24,570,0,0
706419_452659_0211Acta0211.jpg,040801013.02.1.0001,165,412,13,590,0,0
706419_540825_0097Acta0097.jpg,040801003.04.1.0001,93,401,11,505,0,0
706419_561550_0114Acta0114.jpg,040801034.01.1.0001,113,200,10,323,1,1
706419_672679_0197Acta0197.jpg,040801004.04.1.0001,145,369,13,527,0,0
706419_681861_0116Acta0116.jpg,040801021.02.1.0001,133,253,12,398,0,0
706419_707399_0147Acta0147.jpg,040801009.01.1.0001,109,346,14,469,0,0
706419_776529_0112Acta0112.jpg,040801002.01.1.0001,123,351,14,488,0,0
706419_810350_0100Acta0100.jpg,040801020.01.1.0001,170,343,21,534,0,0
706419_928617_0104Acta0104.jpg,040801015.01.1.0001,162,332,31,525,0,0
709047_203462_0248Acta0115.jpg,122301002.01.1.0001,67,410,8,485,0,0
709047_929267_0238Acta0108.jpg,121103002.01.1.0001,90,284,8,382,0,0
709624_037479_0520Acta0351.jpg,181801001.03.1.0001,67,535,9,611,0,0
709624_174633_0537Acta0356.jpg,181201002.04.1.0001,49,401,13,463,0,0
709624_212014_0159Acta0072.jpg,180401018.01.1.0001,86,348,9,443,0,0
709624_298196_0257Acta0170.jpg,180401001.03.1.0001,46,421,6,473,0,0
709624_327190_0379Acta0264.jpg,181801003.02.1.0001,54,427,5,486,0,0
709624_329819_0434Acta0293.jpg,180401007.04.1.0001,87,466,11,564,0,0
709624_497641_0198Acta0111.jpg,181301002.03.1.0001,79,519,17,615,0,0
709624_591341_0529Acta0354.jpg,181201004.03.1.0001,59,526,6,591,0,0
709624_614192_0446Acta0298.jpg,180702001.01.1.0001,80,329,8,417,0,0
709624_648402_0543Acta0358.jpg,181201011.02.1.0001,75,520,6,601,0,0
709624_676104_0452Acta0300.jpg,180701001.01.1.0001,121,407,6,534,0,0
709624_707025_0557Acta0364.jpg,181201014.02.1.0001,82,272,8,362,0,0
709624_728660_0515Acta0349.jpg,181801003.01.1.0001,40,364,5,409,0,0
709624_772869_0321Acta0234.jpg,180401006.02.1.0001,29,260,4,293,0,0
709624_903686_0200Acta0113.jpg,181301007.02.1.0001,69,431,9,509,0,0
709624_960162_0508Acta0347.jpg,181801002.01.1.0001,39,226,6,271,0,0
720411_070066_0082Acta0082.jpg,190202017.01.1.0001,168,204,8,380,0,0
720411_153715_0144Acta0144.jpg,190207010.02.1.0001,167,289,6,462,0,0
720411_164005_0058Acta0058.jpg,190201025.01.1.0001,90,306,6,402,0,0
720411_229359_0060Acta0060.jpg,190201001.01.1.0001,83,379,6,468,0,0
720411_285731_0164Acta0164.jpg,190209001.01.1.0001,157,291,10,458,0,0
720411_306832_0158Acta0158.jpg,190202002.03.1.0001,128,419,8,555,0,0
720411_487583_0132Acta0132.jpg,190206001.01.1.0001,76,441,11,528,0,0
720411_844800_0182Acta0182.jpg,190201003.02.1.0001,143,272,8,423,0,0
720411_987614_0149Acta0149.jpg,190207008.01.1.0001,148,214,10,372,0,0
720660_022770_0021Acta0020.jpg,110207057.04.1.0001,126,357,8,491,0,0
720660_099931_0087Acta0086.jpg,110207001.04.1.0001,86,394,7,487,0,0
720660_105623_0132Acta0131.jpg,110207033.03.1.0001,107,340,26,473,0,0
720660_315308_0091Acta0090.jpg,110207005.02.1.0001,144,432,10,586,0,0
720660_332069_0049Acta0048.jpg,110207008.02.1.0001,83,411,12,506,0,0
720660_358294_0101Acta0100.jpg,110207032.04.1.0001,98,468,13,579,0,0
720660_363226_0090Acta0089.jpg,110207005.01.1.0001,131,426,12,569,0,0
720660_404733_0088Acta0087.jpg,110207071.01.1.0001,211,315,15,541,0,0
720660_414877_0137Acta0136.jpg,110207053.02.1.0001,202,397,21,620,0,0
720660_415810_0160Acta0159.jpg,110207062.02.1.0001,143,460,11,614,0,0
720660_439227_0166Acta0165.jpg,110207059.03.1.0001,116,450,11,577,0,0
720660_463120_0081Acta0080.jpg,110207149.01.1.0001,153,206,9,368,0,0
720660_467983_0084Acta0083.jpg,110207001.01.1.0001,97,363,3,463,0,0
720660_515386_0192Acta0191.jpg,110207076.01.1.0001,230,338,18,586,0,0
720660_519148_0205Acta0203.jpg,110207064.03.1.0001,159,366,17,542,0,0
720660_522294_0072Acta0071.jpg,110207019.02.1.0001,135,405,20,560,0,0
720660_524944_0047Acta0046.jpg,110207017.04.1.0001,106,419,12,537,0,0
720660_529837_0107Acta0106.jpg,110207039.03.1.0001,115,376,24,515,0,0
720660_550596_0224Acta0222.jpg,110207143.03.1.0001,130,350,17,497,0,0
720660_554348_0057Acta0056.jpg,110207031.03.1.0001,122,451,20,593,0,0
720660_621170_0220Acta0218.jpg,110207079.02.1.0001,139,337,14,490,0,0
720660_641885_0070Acta0069.jpg,110207142.02.1.0001,129,453,14,596,0,0
720660_656401_0056Acta0055.jpg,110207031.02.1.0001,151,409,16,576,0,0
720660_734407_0059Acta0058.jpg,110207058.02.1.0001,161,464,13,638,0,0
720660_775971_0025Acta0024.jpg,110207025.03.1.0001,101,458,16,575,0,0
720660_836854_0099Acta0098.jpg,110207032.02.1.0001,122,470,14,606,0,0
720660_901738_0014Acta0013.jpg,110207029.02.1.0001,122,372,17,511,0,0
720660_957714_0054Acta0053.jpg,110207072.03.1.0001,134,317,15,466,0,0
725392_369948_0081Acta0081.jpg,100402001.01.1.0001,220,347,17,584,0,0
725392_372849_0094Acta0094.jpg,100401003.04.1.0001,146,502,9,657,0,0
725392_380467_0078Acta0078.jpg,100401005.02.1.0001,234,317,21,572,0,0
725392_534362_0126Acta0126.jpg,100401002.02.1.0001,312,284,12,608,0,0
725392_602537_0092Acta0092.jpg,100401003.01.1.0001,132,440,17,589,0,0
725392_662483_0103Acta0103.jpg,100901001.02.1.0001,206,270,9,485,0,0
725392_789227_0073Acta0073.jpg,100405001.01.1.0001,163,304,12,479,0,0
727113_002387_0081Acta0081.jpg,211402008.01.1.0001,139,315,9,463,0,0
727113_062537_0217Acta0217.jpg,211406003.03.1.0001,73,317,5,395,0,0
727113_070394_0218Acta0218.jpg,211406003.02.1.0001,74,292,7,373,0,0
727113_146193_0151Acta0151.jpg,211408007.04.1.0001,132,276,7,415,0,0
727113_179269_0196Acta0196.jpg,211401006.03.1.0001,107,282,5,394,0,0
727113_236966_0166Acta0166.jpg,211401001.04.1.0001,100,316,2,418,0,0
727113_290925_0168Acta0168.jpg,211401001.01.1.0001,98,276,8,382,0,0
727113_369760_0143Acta0143.jpg,211404003.02.1.0001,110,347,8,465,0,0
727113_417266_0163Acta0163.jpg,211408010.01.1.0001,215,285,6,506,0,0
727113_430596_0198Acta0198.jpg,211401005.01.1.0001,95,309,10,414,0,0
727113_437309_0211Acta0211.jpg,211406006.03.1.0001,72,265,8,345,1,1
727113_526449_0201Acta0201.jpg,211406010.01.1.0001,83,337,10,430,0,0
727113_621257_0154Acta0154.jpg,211408001.02.1.0001,118,390,8,516,0,0
727113_678549_0182Acta0182.jpg,211401004.04.1.0001,115,361,9,485,0,0
727113_834500_0195Acta0195.jpg,211401006.01.1.0001,90,302,6,398,0,0
727113_872742_0144Acta0144.jpg,211404003.03.1.0001,110,357,7,474,0,0
727113_890108_0007Acta0007.jpg,211403021.01.1.0001,110,300,7,417,0,0
727113_890468_0137Acta0137.jpg,211404012.01.1.0001,149,389,4,542,0,0
727113_904948_0083Acta0083.jpg,211402008.03.1.0001,136,316,8,460,0,0
727113_925400_0170Acta0170.jpg,211401003.01.1.0001,55,238,9,302,0,0
727113_939377_0174Acta0174.jpg,211401008.02.1.0001,78,329,11,418,0,0
727113_974032_0173Acta0173.jpg,211401013.03.1.0001,69,285,6,360,0,0
727113_978199_0181Acta0181.jpg,211401004.02.1.0001,130,339,12,481,0,0
727585_038177_0767Acta0767.jpg,050210010.02.1.0001,121,395,5,521,0,0
727585_044298_0327Acta0327.jpg,050209006.02.1.0001,85,432,9,526,0,0
727585_057555_0097Acta0097.jpg,050209004.01.1.0001,114,435,18,567,0,0
727585_094608_0502Acta0502.jpg,050302001.01.1.0001,100,397,8,505,0,0
727585_112111_0110Acta0110.jpg,050208007.02.1.0001,59,401,4,464,0,0
727585_120160_0181Acta0181.jpg,050207002.01.1.0001,80,467,7,554,1,1
727585_139854_0386Acta0386.jpg,050211019.03.1.0001,154,330,13,497,0,0
727585_144921_0128Acta0128.jpg,050208011.02.1.0001,137,359,6,502,0,0
727585_146922_0474Acta0474.jpg,050302002.02.1.0001,115,368,13,496,0,0
727585_158410_0341Acta0341.jpg,050212001.03.1.0001,114,423,4,541,0,0
727585_175541_0167Acta0167.jpg,050202002.01.1.0001,100,316,11,427,1,1
727585_198215_0453Acta0453.jpg,050206002.01.1.0001,87,238,9,334,0,0
727585_222306_0317Acta0317.jpg,050209028.02.1.0001,91,230,7,328,0,0
727585_257608_0090Acta0090.jpg,050209010.02.1.0001,121,388,17,526,0,0
727585_304570_0636Acta0636.jpg,050902023.01.1.0001,245,148,7,400,0,0
727585_316755_0711Acta0711.jpg,050210005.05.1.0001,112,443,10,565,0,0
727585_316920_0648Acta0648.jpg,050901009.01.1.0001,177,319,3,499,0,0
727585_335830_0415Acta0415.jpg,050210006.02.1.0001,98,463,8,569,0,0
727585_409743_0369Acta0369.jpg,050211027.01.1.0001,95,361,8,464,0,0
727585_417065_0188Acta0188.jpg,050207010.02.1.0001,79,502,4,585,0,0
727585_450872_0209Acta0209.jpg,050207004.01.1.0001,98,454,7,559,0,0
727585_457915_0077Acta0077.jpg,050209004.02.1.0001,129,439,12,580,0,0
727585_466504_0270Acta0270.jpg,050503001.03.1.0001,107,340,13,460,0,0
727585_510798_0674Acta0674.jpg,050901001.02.1.0001,131,399,12,542,0,0
727585_527288_0146Acta0146.jpg,050214003.01.1.0001,131,370,10,511,0,0
727585_571768_0597Acta0597.jpg,050601007.03.1.0001,52,429,2,483,0,0
727585_586645_0086Acta0086.jpg,050209022.01.1.0001,143,367,8,518,0,0
727585_612912_0589Acta0589.jpg,050601011.01.1.0001,89,472,3,564,0,0
727585_646167_0701Acta0701.jpg,050303008.01.1.0001,154,157,2,313,0,0
727585_660125_0165Acta0165.jpg,050202003.01.1.0001,110,409,7,526,0,0
727585_668543_0164Acta0164.jpg,050202002.02.1.0001,97,292,11,400,0,0
727585_756342_0100Acta0100.jpg,050208001.03.1.0001,91,381,8,480,0,0
727585_770348_0460Acta0460.jpg,050301001.01.1.0001,70,208,3,281,0,0
727585_812918_0212Acta0212.jpg,050207008.03.1.0001,108,460,10,578,0,0
727585_844061_0424Acta0424.jpg,050211009.01.1.0001,170,417,8,595,0,0
727585_853842_0647Acta0647.jpg,050902003.01.1.0001,238,204,10,452,0,0
727585_875570_0147Acta0147.jpg,050214003.02.1.0001,142,315,5,462,0,0
727585_877201_0224Acta0224.jpg,050207015.01.1.0001,41,102,2,145,0,0
727585_878757_0450Acta0450.jpg,050206001.03.1.0001,109,367,6,482,0,0
727585_881936_0535Acta0535.jpg,051101002.03.1.0001,104,302,2,408,0,0
727585_899865_0441Acta0441.jpg,050203001.02.1.0001,116,462,11,589,0,0
727585_901696_0175Acta0175.jpg,050207006.01.1.0001,96,425,8,529,0,0
727585_932342_0163Acta0163.jpg,050202004.02.1.0001,75,348,3,426,0,0
727585_936037_0455Acta0455.jpg,050206001.02.1.0001,110,345,3,458,0,0
727585_961157_0285Acta0285.jpg,050504006.02.1.0001,91,250,6,347,0,0
727585_967086_0509Acta0509.jpg,050302007.03.1.0001,92,414,2,508,0,0
727585_984292_0726Acta0726.jpg,050902011.01.1.0001,189,389,17,595,0,0
727702_068965_0212Acta0084.jpg,131301009.05.1.0001,46,393,8,447,1,1
727702_095812_0146Acta0046.jpg,131301010.01.1.0001,37,336,6,379,1,1
727702_230501_0312Acta0137.jpg,131701005.02.1.0001,81,425,12,518,0,0
727702_235599_0305Acta0130.jpg,131301004.01.1.0001,119,331,12,462,0,0
727702_376501_0161Acta0059.jpg,131301019.01.1.0001,95,348,5,448,0,0
727702_410155_0279Acta0113.jpg,131701010.03.1.0001,102,366,9,477,0,0
727702_410197_0291Acta0119.jpg,131701009.02.1.0001,124,404,22,550,0,0
727702_418831_0155Acta0054.jpg,131301014.03.1.0001,135,385,15,535,0,0
727702_429700_0184Acta0075.jpg,131301013.02.1.0001,103,365,7,475,0,0
727702_530599_0308Acta0133.jpg,131701009.03.1.0001,134,415,20,569,0,0
727702_609096_0248Acta0100.jpg,131701011.01.1.0001,94,420,11,525,0,0
727702_622297_0313Acta0138.jpg,131701003.02.1.0001,91,400,12,503,0,0
727702_633986_0177Acta0072.jpg,131301027.07.1.0001,113,388,19,520,0,0
727702_642139_0192Acta0078.jpg,131301001.03.1.0001,71,407,6,484,0,0
727702_876734_0262Acta0107.jpg,131701012.04.1.0001,143,402,12,557,0,0
727702_895129_0215Acta0085.jpg,131301009.03.1.0001,55,314,5,374,0,0
727702_900426_0237Acta0096.jpg,131701017.01.1.0001,52,354,9,415,0,0
745895_378515_0143Acta0143.jpg,100101065.01.1.0001,144,92,6,242,0,0
745895_468917_0104Acta0104.jpg,101101010.02.1.0001,129,385,13,527,0,0
745895_482901_0015Acta0015.jpg,100101011.01.1.0001,84,518,12,614,0,0
745895_499585_0022Acta0022.jpg,100101002.03.1.0001,212,414,17,643,0,0
745895_572911_0110Acta0110.jpg,101101015.01.1.0001,259,293,4,556,0,0
745895_624814_0134Acta0134.jpg,101301010.01.1.0001,194,274,22,490,0,0
745895_665165_0118Acta0118.jpg,101301002.02.1.0001,176,357,7,540,0,0
745895_669132_0036Acta0036.jpg,100101015.05.1.0001,142,430,9,581,0,0
745895_684196_0078Acta0078.jpg,100101013.05.1.0001,103,462,15,580,0,0
745895_730379_0086Acta0086.jpg,100101003.01.1.0001,219,434,10,663,0,0
745895_730744_0099Acta0099.jpg,101101007.01.1.0001,83,191,5,279,2,2
745895_734025_0077Acta0077.jpg,100101013.03.1.0001,89,458,13,560,0,0
745895_770978_0079Acta0079.jpg,100101013.04.1.0001,73,478,15,566,0,0
745895_873782_0051Acta0051.jpg,100101018.01.1.0001,110,299,11,420,0,0
745895_959992_0068Acta0068.jpg,100101016.01.1.0001,214,293,19,526,0,0
746782_002143_0034Acta0030.jpg,100601026.02.1.0001,102,404,5,511,0,0
746782_282424_0128Acta0124.jpg,100602001.02.1.0001,175,210,5,390,0,0
746782_289723_0145Acta0141.jpg,100601004.02.1.0001,179,310,15,504,0,0
746782_323237_0050Acta0046.jpg,100601006.02.1.0001,80,376,8,464,0,0
746782_342192_0046Acta0042.jpg,100601011.01.1.0001,135,318,18,471,0,0
746782_446194_0030Acta0026.jpg,100601010.01.1.0001,151,367,16,534,0,0
746782_469820_0062Acta0058.jpg,100601015.03.1.0001,112,399,7,518,0,0
746782_525856_0036Acta0032.jpg,100601026.03.1.0001,76,416,6,498,0,0
746782_544100_0065Acta0061.jpg,100601017.02.1.0001,98,358,12,468,0,0
746782_548659_0143Acta0139.jpg,100601007.02.1.0001,133,506,16,655,0,0
746782_586115_0056Acta0052.jpg,100601005.01.1.0001,145,426,14,585,2,2
746782_676675_0077Acta0073.jpg,100601014.03.1.0001,153,301,11,465,0,0
746782_686982_0067Acta0063.jpg,100601017.03.1.0001,93,384,8,485,0,0
746782_731885_0098Acta0094.jpg,100601003.04.1.0001,159,381,19,559,0,0
746782_772305_0072Acta0068.jpg,100601057.01.1.0001,90,91,7,188,0,0
746782_815764_0087Acta0083.jpg,100601018.03.1.0001,144,391,17,552,0,0
746782_879136_0066Acta0062.jpg,100601017.01.1.0001,82,352,13,447,0,0
746782_896594_0094Acta0090.jpg,100601024.03.1.0001,123,344,9,476,0,0
746782_917582_0121Acta0117.jpg,100601022.02.1.0001,121,394,9,524,0,0
746782_923828_0097Acta0093.jpg,100601003.03.1.0001,149,351,21,521,0,0
746782_970705_0037Acta0033.jpg,100601009.02.1.0001,205,402,8,615,0,0
751094_088944_0079Acta0079.jpg,021401009.04.1.0001,128,320,11,459,0,0
751094_176555_0059Acta0059.jpg,021401012.02.1.0001,150,328,20,498,0,0
751094_289358_0138Acta0138.jpg,021201006.04.1.0001,159,362,21,542,0,0
751094_297065_0025Acta0025.jpg,021201034.02.1.0001,87,358,10,455,0,0
751094_321927_0253Acta0253.jpg,021401016.02.1.0001,147,306,12,465,0,0
751094_397618_0068Acta0068.jpg,021401012.01.1.0001,160,379,21,560,0,0
751094_417371_0224Acta0224.jpg,020901002.04.1.0001,145,421,14,580,0,0
751094_420887_0290Acta0290.jpg,021003001.01.1.0001,152,249,18,419,0,0
751094_456296_0047Acta0047.jpg,021201036.02.1.0001,79,394,7,480,0,0
751094_501307_0156Acta0156.jpg,021201023.02.1.0001,97,388,14,499,0,0
751094_506379_0209Acta0209.jpg,020901004.03.1.0001,118,392,17,527,0,0
751094_557284_0049Acta0049.jpg,021201010.01.1.0001,182,391,22,595,0,0
751094_562083_0158Acta0158.jpg,021201011.01.1.0001,117,365,18,500,0,0
751094_583339_0198Acta0198.jpg,020901006.02.1.0001,171,463,7,641,1,1
751094_602653_0118Acta0118.jpg,021201019.01.1.0001,106,435,16,557,0,0
751094_620110_0210Acta0210.jpg,020901004.04.1.0001,136,389,9,534,0,0
751094_622868_0048Acta0048.jpg,021201036.03.1.0001,83,398,9,490,1,1
751094_644477_0282Acta0282.jpg,021201005.03.1.0001,113,308,11,432,0,0
751094_651118_0208Acta0208.jpg,020901004.02.1.0001,108,384,15,507,0,0
751094_661366_0254Acta0254.jpg,021401016.03.1.0001,155,347,14,516,0,0
751094_680357_0123Acta0123.jpg,021201039.02.1.0001,71,266,5,342,0,0
751094_704943_0060Acta0060.jpg,021401026.02.1.0001,126,356,13,495,0,0
751094_714070_0221Acta0221.jpg,020901002.01.1.0001,154,423,10,587,0,0
751094_721959_0184Acta0184.jpg,020902003.01.1.0001,167,199,5,371,0,0
751094_857199_0071Acta0071.jpg,021401010.03.1.0001,78,357,20,455,0,0
751094_860876_0062Acta0062.jpg,021401005.03.1.0001,137,351,20,508,0,0
751094_867968_0176Acta0176.jpg,021201014.01.1.0001,101,396,5,502,0,0
751094_877115_0027Acta0027.jpg,021201034.03.1.0001,77,367,17,461,0,0
751094_948617_0038Acta0038.jpg,021201028.02.1.0001,83,402,20,505,0,0
751094_956131_0086Acta0086.jpg,021401001.02.1.0001,137,371,17,525,0,0
752341_040149_0064Acta0057.jpg,020302001.01.1.0001,139,377,23,539,0,0
752341_086149_0019Acta0012.jpg,020302034.02.1.0001,82,263,14,359,0,0
752341_095102_0206Acta0199.jpg,020306002.02.1.0001,129,206,13,348,1,1
752341_098743_0175Acta0168.jpg,020302004.04.1.0001,224,322,30,576,0,0
752341_131095_0042Acta0035.jpg,020302013.02.1.0001,0,0,0,0,0,0
752341_188113_0171Acta0164.jpg,020302038.03.1.0001,110,407,13,530,0,0
752341_189221_0049Acta0042.jpg,020302028.08.1.0001,53,405,7,465,0,0
752341_234211_0129Acta0122.jpg,020302085.01.1.0001,128,137,8,273,0,0
752341_270236_0070Acta0063.jpg,020302002.03.1.0001,166,276,11,453,0,0
752341_274369_0158Acta0151.jpg,020302041.05.1.0001,190,396,18,604,0,0
752341_350046_0187Acta0180.jpg,020302040.02.1.0001,191,318,25,534,0,0
752341_379755_0046Acta0039.jpg,020302013.05.1.0001,167,409,12,588,0,0
752341_397063_0173Acta0166.jpg,020302038.05.1.0001,120,407,18,545,1,1
752341_490389_0118Acta0111.jpg,020302029.01.1.0001,151,407,20,578,0,0
752341_523605_0048Acta0041.jpg,020302028.01.1.0001,52,446,5,503,0,0
752341_533365_0169Acta0162.jpg,020302038.01.1.0001,124,410,16,550,0,0
752341_570291_0214Acta0207.jpg,020302017.02.1.0001,62,361,13,436,0,0
752341_573445_0116Acta0109.jpg,020302064.02.1.0001,146,396,11,553,0,0
752341_619844_0145Acta0138.jpg,020302032.03.1.0001,138,368,19,525,0,0
752341_651669_0128Acta0121.jpg,020306004.04.1.0001,185,263,8,456,0,0
752341_665509_0216Acta0209.jpg,020305001.01.1.0001,310,251,19,580,0,0
752341_712581_0066Acta0059.jpg,020302001.03.1.0001,156,382,12,550,0,0
752341_750318_0034Acta0027.jpg,020302024.01.1.0001,139,442,13,594,0,0
752341_777172_0020Acta0013.jpg,020302034.01.1.0001,94,281,8,383,0,0
752341_805147_0097Acta0090.jpg,020302043.01.1.0001,174,139,17,330,0,0
752341_909467_0119Acta0112.jpg,020302029.03.1.0001,157,407,18,582,0,0
753682_427420_0117Acta0066.jpg,150702001.01.1.0001,126,364,10,500,1,1
753682_551788_0121Acta0070.jpg,150701001.03.1.0001,126,416,22,564,0,0
753682_781997_0116Acta0065.jpg,150702001.03.1.0001,127,357,9,493,0,0
758385_085221_1063Acta0086.jpg,132001007.01.1.0001,286,200,11,497,0,0
758385_129276_1005Acta0035.jpg,130203001.02.1.0001,163,329,14,506,1,1
758385_139460_1076Acta0092.jpg,130601002.01.1.0001,198,224,17,439,0,0
758385_269490_1083Acta0094.jpg,130605001.01.1.0001,308,255,23,586,0,0
758385_352296_1012Acta0041.jpg,131401003.02.1.0001,252,247,16,515,0,0
758385_425151_1077Acta0092.jpg,130601002.02.1.0001,166,245,12,423,0,0
758385_438624_1125Acta0114.jpg,132102001.01.1.0001,152,173,11,336,0,0
758385_445126_1114Acta0104.jpg,131401002.03.1.0001,225,259,9,493,0,0
758385_483040_1018Acta0047.jpg,131401002.01.1.0001,202,250,13,465,0,0
758385_517271_1111Acta0102.jpg,132101003.03.1.0001,263,160,22,445,0,0
758385_547559_1011Acta0040.jpg,131401007.01.1.0001,288,90,11,389,0,0
758385_608492_1017Acta0046.jpg,131401002.02.1.0001,210,259,12,481,0,0
758385_675965_1091Acta0097.jpg,130601001.02.1.0001,198,296,13,507,0,0
758385_696738_1048Acta0075.jpg,132001012.05.1.0001,212,221,19,452,0,0
768831_050569_0207Acta0174.jpg,110201010.03.1.0001,56,375,8,439,0,0
768831_059011_0128Acta0104.jpg,110201014.04.1.0001,26,373,3,402,0,0
768831_060658_0189Acta0156.jpg,110201007.02.1.0001,77,388,17,482,0,0
768831_129117_0169Acta0136.jpg,110202026.01.1.0001,44,416,3,463,0,0
768831_152598_0195Acta0162.jpg,110201036.03.1.0001,173,462,21,656,0,0
768831_190342_0116Acta0092.jpg,110201033.02.1.0001,86,303,14,403,0,0
768831_211964_0196Acta0163.jpg,110201036.01.1.0001,177,462,16,655,0,0
768831_315860_0127Acta0103.jpg,110201049.03.1.0001,73,380,5,458,0,0
768831_321938_0133Acta0109.jpg,110201014.02.1.0001,29,400,4,433,0,0
768831_348635_0210Acta0177.jpg,110201010.04.1.0001,56,398,4,458,0,0
768831_419788_0124Acta0100.jpg,110201049.02.1.0001,75,362,5,442,1,1
768831_424749_0193Acta0160.jpg,110201007.04.1.0001,85,341,10,436,0,0
768831_502499_0214Acta0181.jpg,110201024.03.1.0001,98,430,10,538,0,0
768831_544490_0119Acta0095.jpg,110201022.01.1.0001,73,370,8,451,0,0
768831_563117_0123Acta0099.jpg,110201049.01.1.0001,68,398,10,476,0,0
768831_589921_0136Acta0112.jpg,110201040.01.1.0001,126,256,4,386,0,0
768831_624183_0216Acta0183.jpg,110201042.02.1.0001,102,402,14,518,0,0
768831_691031_0114Acta0090.jpg,110201004.01.1.0001,75,419,10,504,0,0
768831_733009_0126Acta0102.jpg,110201049.04.1.0001,63,390,10,463,0,0
768831_781568_0120Acta0096.jpg,110201022.02.1.0001,58,393,4,455,0,0
768831_846481_0209Acta0176.jpg,110201010.02.1.0001,56,383,9,448,0,0
768831_876623_0132Acta0108.jpg,110201014.03.1.0001,35,369,8,412,0,0
768831_897409_0153Acta0123.jpg,110202031.03.1.0001,94,383,8,485,0,0
770496_097097_0025Acta0025.jpg,110601002.01.1.0001,188,404,20,612,0,0
770496_102189_0100Acta0100.jpg,110601004.01.1.0001,109,412,8,529,0,0
770496_109046_0087Acta0087.jpg,110601017.05.1.0001,181,406,11,598,0,0
770496_167735_0167Acta0167.jpg,110601009.04.1.0001,129,476,3,608,0,0
770496_242343_0091Acta0091.jpg,110601013.02.1.0001,114,497,15,626,0,0
770496_246031_0011Acta0011.jpg,110601011.04.1.0001,135,436,10,581,0,0
770496_288697_0125Acta0125.jpg,110615002.01.1.0001,207,293,9,509,0,0
770496_298873_0092Acta0092.jpg,110601013.03.1.0001,124,482,13,619,0,0
770496_310322_0107Acta0107.jpg,110614005.01.1.0001,96,298,12,406,0,0
770496_319334_0119Acta0119.jpg,110609001.01.1.0001,191,295,7,493,0,0
770496_359286_0098Acta0098.jpg,110601031.03.1.0001,176,274,8,458,0,0
770496_404282_0090Acta0090.jpg,110601013.01.1.0001,121,501,14,636,0,0
770496_463514_0067Acta0067.jpg,110606001.02.1.0001,119,344,10,473,0,0
770496_506672_0154Acta0154.jpg,110612003.03.1.0001,58,415,21,494,0,0
770496_517854_0244Acta0244.jpg,110614004.01.1.0001,71,295,27,393,0,0
770496_584910_0182Acta0182.jpg,110601001.02.1.0001,102,447,4,553,0,0
770496_585724_0159Acta0159.jpg,110616003.01.1.0001,163,178,7,348,0,0
770496_663797_0212Acta0212.jpg,110601041.01.1.0001,161,382,12,555,0,0
770496_693860_0041Acta0041.jpg,110601018.03.1.0001,53,394,0,447,0,0
770496_797786_0191Acta0191.jpg,110601052.01.1.0001,224,312,9,545,0,0
770496_808776_0199Acta0199.jpg,110617003.01.1.0001,36,53,0,89,0,0
770496_815879_0083Acta0083.jpg,110601017.01.1.0001,160,433,8,601,0,0
770496_936246_0031Acta0031.jpg,110601024.02.1.0001,73,476,8,557,0,0
770496_982965_0020Acta0020.jpg,110601044.01.1.0001,369,214,9,592,0,0
771068_012227_0177Acta0175.jpg,041001016.01.1.0001,151,424,18,593,0,0
771068_073227_0235Acta0233.jpg,041701021.01.1.0001,188,390,17,595,0,0
771068_105659_0134Acta0132.jpg,040902021.01.1.0001,138,354,16,508,0,0
771068_137563_0286Acta0284.jpg,041702007.01.1.0001,154,278,15,447,0,0
771068_225927_0205Acta0203.jpg,041701006.03.1.0001,154,366,31,551,0,0
771068_250387_0273Acta0271.jpg,041702003.02.1.0001,147,391,23,561,0,0
771068_277266_0158Acta0156.jpg,040902022.04.1.0001,108,373,13,494,0,0
771068_334753_0145Acta0143.jpg,040901003.01.1.0001,84,380,22,486,0,0
771068_429524_0210Acta0208.jpg,041701007.03.1.0001,148,393,22,563,0,0
771068_436197_0106Acta0104.jpg,040902003.02.1.0001,160,327,27,514,0,0
771068_462007_0214Acta0212.jpg,041701009.02.1.0001,100,344,16,460,0,0
771068_468578_0315Acta0313.jpg,041703003.04.1.0001,152,315,19,486,0,0
771068_497738_0206Acta0204.jpg,041701006.04.1.0001,148,343,25,516,0,0
771068_712773_0192Acta0190.jpg,041701002.01.1.0001,129,268,23,420,0,0
771068_725168_0176Acta0174.jpg,041001014.03.1.0001,154,325,14,493,0,0
771068_776618_0338Acta0336.jpg,040102001.02.1.0001,164,286,16,466,0,0
771068_885273_0270Acta0268.jpg,041702001.03.1.0001,107,412,14,533,0,0
771068_906180_0123Acta0121.jpg,040901002.02.1.0001,100,321,14,435,0,0
771068_915324_0326Acta0324.jpg,040902027.01.1.0001,137,281,15,433,0,0
771068_930064_0283Acta0281.jpg,041702006.01.1.0001,122,309,17,448,0,0
771437_119819_0029Acta0029.jpg,080301002.01.1.0001,201,441,19,661,0,0
771437_805715_0039Acta0039.jpg,080301001.01.1.0001,214,352,17,583,0,0
771727_204732_0142Acta0142.jpg,160901016.01.1.0001,144,144,2,290,0,0
771727_222265_0110Acta0110.jpg,160704003.01.1.0001,250,326,4,580,0,0
771727_301583_0155Acta0155.jpg,160901002.01.1.0001,140,490,15,645,0,0
771727_486139_0064Acta0064.jpg,160701001.01.1.0001,181,166,2,349,0,0
771727_561238_0144Acta0144.jpg,160901018.01.1.0001,210,187,9,406,0,0
771727_587582_0157Acta0157.jpg,160901015.01.1.0001,148,260,18,426,0,0
771727_642999_0169Acta0169.jpg,160305002.01.1.0001,210,231,12,453,0,0
771727_772332_0067Acta0067.jpg,160702005.01.1.0001,111,132,2,245,0,0
771727_800047_0181Acta0181.jpg,160302002.01.1.0001,109,86,1,196,0,0
771727_841917_0125Acta0125.jpg,160706001.01.1.0001,76,218,3,297,0,0
772156_003157_0101Acta0101.jpg,210303013.01.1.0001,117,146,1,264,0,0
772156_026384_0174Acta0174.jpg,210305025.01.1.0001,283,180,14,477,0,0
772156_059622_0130Acta0130.jpg,210302001.01.1.0001,116,335,2,453,0,0
772156_089925_0089Acta0089.jpg,210303005.01.1.0001,64,261,1,326,0,0
772156_120999_0152Acta0152.jpg,210305001.01.1.0001,101,452,7,560,0,0
772156_225154_0124Acta0124.jpg,210301004.02.1.0001,104,407,1,512,0,0
772156_231359_0082Acta0082.jpg,210305008.05.1.0001,95,497,5,597,0,0
772156_329767_0158Acta0158.jpg,210305013.01.1.0001,73,245,1,319,0,0
772156_392987_0106Acta0106.jpg,210303010.01.1.0001,107,198,7,312,0,0
772156_664473_0140Acta0140.jpg,210302010.01.1.0001,103,83,8,194,0,0
772156_758178_0110Acta0110.jpg,210303018.01.1.0001,145,309,5,459,0,0
772448_042310_0107Acta0107.jpg,110101012.01.1.0001,103,171,6,280,0,0
772448_049774_0071Acta0071.jpg,110102002.01.1.0001,269,316,11,596,0,0
772448_228481_0027Acta0027.jpg,110205003.03.1.0001,108,336,10,454,0,0
772448_344996_0100Acta0100.jpg,110101010.01.1.0001,242,162,17,421,0,0
772448_352996_0019Acta0019.jpg,110205012.02.1.0001,189,418,24,631,0,0
772448_364892_0015Acta0015.jpg,110205007.04.1.0001,120,399,9,528,0,0
772448_564435_0064Acta0064.jpg,110206006.03.1.0001,138,398,14,550,1,1
772448_571718_0032Acta0032.jpg,110206004.02.1.0001,250,394,40,684,0,0
772448_617433_0060Acta0060.jpg,110206006.02.1.0001,160,374,20,554,0,0
772448_723711_0092Acta0092.jpg,110102010.01.1.0001,284,395,29,708,0,0
772584_076164_0175Acta0164.jpg,210407007.01.1.0001,167,334,9,510,1,1
772584_126767_0094Acta0083.jpg,210404014.01.1.0001,238,238,6,482,0,0
772584_141662_0069Acta0058.jpg,210404015.01.1.0001,406,299,13,718,0,0
772584_152184_0144Acta0133.jpg,210402006.03.1.0001,134,364,10,508,0,0
772584_252524_0198Acta0187.jpg,210407010.03.1.0001,218,172,4,394,0,0
772584_275944_0062Acta0051.jpg,210404004.01.1.0001,184,394,4,582,1,1
772584_279939_0197Acta0186.jpg,210407010.02.1.0001,229,172,4,405,0,0
772584_326015_0089Acta0078.jpg,210404003.01.1.0001,336,256,16,608,0,0
772584_366897_0134Acta0123.jpg,210402005.01.1.0001,304,274,9,587,0,0
772584_474564_0106Acta0095.jpg,210405003.02.1.0001,258,215,5,478,0,0
772584_629022_0077Acta0066.jpg,210404005.03.1.0001,221,266,3,490,0,0
772584_653628_0160Acta0149.jpg,210402002.03.1.0001,133,313,10,456,0,0
772584_800194_0145Acta0134.jpg,210402006.04.1.0001,128,368,11,507,0,0
772584_955713_0176Acta0165.jpg,210407007.02.1.0001,149,352,9,510,0,0
782587_499282_0029Acta0029.jpg,100201004.03.1.0001,160,362,15,537,0,0
782587_525433_0033Acta0033.jpg,100201016.01.1.0001,272,311,12,595,0,0
782587_788348_0062Acta0062.jpg,101203001.01.1.0001,173,433,14,620,0,0
784821_079037_0170Acta0169.jpg,240111010.02.1.0001,223,361,25,609,0,0
784821_150678_0072Acta0071.jpg,240104010.04.1.0001,171,289,16,476,0,0
784821_207059_0167Acta0166.jpg,240111011.01.1.0001,187,405,11,603,0,0
784821_289822_0068Acta0067.jpg,240104010.02.1.0001,178,300,18,496,0,0
784821_326907_0081Acta0080.jpg,240104032.01.1.0001,171,271,17,459,0,0
784821_357967_0155Acta0154.jpg,240110010.03.1.0001,150,279,9,438,0,0
784821_403879_0071Acta0070.jpg,240104010.05.1.0001,177,303,13,493,0,0
784821_481348_0125Acta0124.jpg,240111015.03.1.0001,187,376,16,579,1,1
784821_496293_0046Acta0046.jpg,240104041.02.1.0001,198,209,14,421,0,0
784821_533149_0112Acta0111.jpg,240111003.03.1.0001,181,391,12,584,0,0
784821_598950_0055Acta0054.jpg,240104013.04.1.0001,194,357,16,567,0,0
784821_917853_0107Acta0106.jpg,240104018.01.1.0001,270,317,26,613,0,0
784821_956182_0124Acta0123.jpg,240111015.02.1.0001,182,388,14,584,0,0
784821_966000_0169Acta0168.jpg,240111010.01.1.0001,231,349,22,602,0,0
786908_022261_0079Acta0079.jpg,191904003.02.1.0001,184,239,10,433,0,0
786908_091346_0086Acta0086.jpg,191903002.03.1.0001,176,295,7,478,0,0
786908_102289_0143Acta0143.jpg,191003002.01.1.0001,146,122,7,275,0,0
786908_139183_0016Acta0016.jpg,191403001.02.1.0001,176,314,10,500,0,0
786908_163584_0037Acta0037.jpg,191401003.01.1.0001,103,282,0,385,0,0
786908_164631_0141Acta0141.jpg,191001010.01.1.0001,140,334,6,480,1,1
786908_167225_0056Acta0056.jpg,190901002.04.1.0001,102,290,3,395,0,0
786908_354849_0036Acta0036.jpg,191401003.02.1.0001,152,277,7,436,0,0
786908_438392_0118Acta0118.jpg,191502002.01.1.0001,134,152,3,289,0,0
786908_470444_0156Acta0156.jpg,191002001.01.1.0001,175,338,9,522,1,1
786908_470679_0057Acta0057.jpg,190901002.01.1.0001,114,299,3,416,0,0
786908_474498_0124Acta0124.jpg,191603001.02.1.0001,147,397,6,550,0,0
786908_497632_0110Acta0110.jpg,191504001.01.1.0001,183,159,6,348,0,0
786908_555143_0026Acta0026.jpg,191403002.02.1.0001,155,347,6,508,0,0
786908_557671_0085Acta0085.jpg,191902001.01.1.0001,208,196,5,409,0,0
786908_665755_0043Acta0043.jpg,191401005.02.1.0001,109,323,3,435,0,0
786908_754716_0129Acta0129.jpg,191602004.01.1.0001,231,217,5,453,0,0
786908_856114_0145Acta0145.jpg,191003001.01.1.0001,232,212,6,450,0,0
786908_918374_0029Acta0029.jpg,191401001.02.1.0001,150,388,6,544,0,0
786908_938029_0108Acta0108.jpg,191501001.01.1.0001,141,238,7,386,0,0
786908_964665_0027Acta0027.jpg,191403002.03.1.0001,169,353,10,532,0,0
788144_026373_0913Acta0523.jpg,180801026.03.1.0001,72,370,12,454,0,0
788144_028281_0499Acta0273.jpg,180803017.01.1.0001,49,472,9,530,0,0
788144_084978_0927Acta0535.jpg,180801011.01.1.0001,63,359,9,431,0,0
788144_092920_1014Acta0569.jpg,180803004.03.1.0001,73,357,3,433,0,0
788144_115122_0466Acta0258.jpg,180803008.03.1.0001,68,417,11,496,0,0
788144_118900_0610Acta0354.jpg,180803013.01.1.0001,44,412,3,459,0,0
788144_119462_0573Acta0328.jpg,182001012.01.1.0001,78,233,6,317,0,0
788144_149889_0577Acta0332.jpg,182001007.01.1.0001,39,168,1,208,0,0
788144_160686_0209Acta0122.jpg,180802012.07.1.0001,59,471,6,536,0,0
788144_171057_0274Acta0156.jpg,181001002.02.1.0001,84,475,8,567,0,0
788144_202791_0202Acta0117.jpg,180802012.04.1.0001,41,421,6,468,0,0
788144_278324_0655Acta0373.jpg,180801011.03.1.0001,58,386,11,455,0,0
788144_288871_0623Acta0359.jpg,180801012.03.1.0001,64,340,5,409,0,0
788144_292197_0291Acta0165.jpg,181001009.03.1.0001,110,393,9,512,0,0
788144_302951_0692Acta0388.jpg,180801008.01.1.0001,64,356,14,434,0,0
788144_305702_0282Acta0160.jpg,181001012.02.1.0001,128,394,16,538,0,0
788144_317302_0336Acta0194.jpg,181001004.04.1.0001,80,397,5,482,0,0
788144_362755_0132Acta0067.jpg,180803016.03.1.0001,99,380,10,489,2,2
788144_365027_0943Acta0543.jpg,180801025.03.1.0001,79,392,6,477,1,1
788144_375940_0550Acta0315.jpg,182002002.01.1.0001,47,285,6,338,0,0
788144_379960_1041Acta0583.jpg,180803002.02.1.0001,95,383,4,482,0,0
788144_392713_0889Acta0513.jpg,180802011.01.1.0001,52,412,5,469,0,0
788144_438090_0868Acta0503.jpg,180802016.02.1.0001,72,427,4,503,0,0
788144_445233_0891Acta0515.jpg,180802023.01.1.0001,89,468,6,563,0,0
788144_449693_1044Acta0584.jpg,180803002.05.1.0001,99,371,9,479,0,0
788144_458095_0521Acta0290.jpg,182003004.01.1.0001,88,483,9,580,0,0
788144_474313_0639Acta0365.jpg,180801001.01.1.0001,58,398,5,461,0,0
788144_503995_0599Acta0350.jpg,180803009.01.1.0001,67,440,12,519,0,0
788144_510460_0277Acta0158.jpg,181001013.01.1.0001,23,75,7,105,1,1
788144_532451_0657Acta0373.jpg,180801011.04.1.0001,55,391,7,453,0,0
788144_563984_0619Acta0356.jpg,180803012.01.1.0001,36,405,10,451,0,0
788144_609955_0189Acta0108.jpg,180802025.01.1.0001,89,369,6,464,0,0
788144_612415_0141Acta0074.jpg,180803029.02.1.0001,50,365,8,423,0,0
788144_614863_0778Acta0445.jpg,180301012.02.1.0001,46,270,8,324,0,0
788144_617249_0609Acta0354.jpg,180803013.02.1.0001,37,417,5,459,0,0
788144_619564_0860Acta0501.jpg,180802010.02.1.0001,53,492,10,555,0,0
788144_684431_0737Acta0415.jpg,180302003.02.1.0001,65,230,6,301,0,0
788144_698047_0149Acta0078.jpg,180802015.02.1.0001,58,369,9,436,0,0
788144_710071_0862Acta0501.jpg,180802010.01.1.0001,44,504,9,557,0,0
788144_717415_0641Acta0365.jpg,180801001.02.1.0001,62,402,5,469,0,0
788144_727055_0936Acta0542.jpg,180801025.01.1.0001,62,414,8,484,0,0
788144_734149_0903Acta0519.jpg,180802008.02.1.0001,36,406,5,447,0,0
788144_796866_0948Acta0546.jpg,180801010.01.1.0001,58,230,4,292,0,0
788144_796915_0679Acta0383.jpg,180801016.03.1.0001,63,374,10,447,0,0
788144_819082_0504Acta0275.jpg,180803019.02.1.0001,70,375,12,457,0,0
788144_853259_0515Acta0285.jpg,180803010.01.1.0001,75,442,5,522,0,0
788144_854916_0746Acta0424.jpg,180301001.01.1.0001,43,382,7,432,0,0
788144_868732_0166Acta0089.jpg,180802006.01.1.0001,41,463,6,510,0,0
788144_874093_0701Acta0394.jpg,180801035.02.1.0001,81,413,6,500,0,0
788144_893434_0398Acta0219.jpg,182801001.03.1.0001,92,366,11,469,0,0
788144_902214_0874Acta0507.jpg,180802001.03.1.0001,55,377,13,445,0,0
788144_926030_0861Acta0501.jpg,180802010.03.1.0001,44,515,5,564,0,0
788144_927570_0481Acta0264.jpg,180803014.04.1.0001,43,444,5,492,0,0
788144_933658_0615Acta0355.jpg,180803012.03.1.0001,53,418,6,477,0,0
788144_944242_0640Acta0365.jpg,180801001.03.1.0001,65,412,11,488,0,0
788144_972449_0205Acta0119.jpg,180802012.05.1.0001,62,430,5,497,0,0
788144_977336_0220Acta0130.jpg,180802018.01.1.0001,58,452,6,516,0,0
788144_998795_1033Acta0578.jpg,180803017.02.1.0001,62,465,11,538,0,0
788458_001353_0321Acta0257.jpg,020301013.05.1.0001,153,416,21,590,0,0
788458_018008_0210Acta0146.jpg,020301017.04.1.0001,122,379,17,518,0,0
788458_153240_0407Acta0343.jpg,020301003.02.1.0001,41,390,6,437,0,0
788458_154739_0216Acta0152.jpg,020301011.03.1.0001,110,428,12,550,0,0
788458_180567_0387Acta0323.jpg,021801002.02.1.0001,172,310,13,495,0,0
788458_229482_0393Acta0329.jpg,021801004.01.1.0001,190,355,19,564,0,0
788458_321543_0288Acta0224.jpg,020301028.01.1.0001,132,391,13,536,0,0
788458_482712_0195Acta0131.jpg,020301031.01.1.0001,159,342,17,518,0,0
788458_507822_0130Acta0066.jpg,021701001.02.1.0001,75,375,11,461,0,0
788458_542410_0227Acta0163.jpg,020301021.01.1.0001,178,390,16,584,0,0
788458_567113_0148Acta0084.jpg,021701002.02.1.0001,47,366,10,423,0,0
788458_569582_0356Acta0292.jpg,020301015.02.1.0001,133,355,13,501,0,0
788458_637823_0349Acta0285.jpg,021301086.02.1.0001,72,325,7,404,0,0
788458_658124_0171Acta0107.jpg,020301027.04.1.0001,146,370,21,537,0,0
788458_693446_0404Acta0340.jpg,020301010.02.1.0001,75,321,5,401,0,0
788458_708613_0175Acta0111.jpg,020301027.06.1.0001,147,412,21,580,0,0
788458_773477_0135Acta0071.jpg,021701007.02.1.0001,30,378,4,412,0,0
788458_780505_0134Acta0070.jpg,021701007.01.1.0001,58,389,5,452,0,0
788458_811376_0386Acta0322.jpg,021801001.03.1.0001,216,299,4,519,0,0
788458_852038_0126Acta0062.jpg,021702001.03.1.0001,54,342,7,403,0,0
788458_865683_0236Acta0172.jpg,020302028.03.1.0001,47,377,8,432,0,0
788458_867094_0323Acta0259.jpg,020301040.02.1.0001,131,476,18,625,0,0
788458_921189_0262Acta0198.jpg,020301026.03.1.0001,119,427,11,557,0,0
788458_930331_0405Acta0341.jpg,020301010.03.1.0001,88,324,10,422,0,0
788458_931447_0367Acta0303.jpg,020301053.01.1.0001,126,433,15,574,0,0
788458_978626_0384Acta0320.jpg,021801001.01.1.0001,160,347,5,512,0,0
788458_980997_0371Acta0307.jpg,020301029.01.1.0001,136,401,20,557,0,0
788458_985404_0297Acta0233.jpg,020301032.03.1.0001,127,353,8,488,0,0
788482_032121_0106Acta0106.jpg,110404001.02.1.0001,202,294,11,507,0,0
788482_072274_0034Acta0034.jpg,110401002.02.1.0001,135,461,11,607,0,0
788482_135593_0087Acta0087.jpg,110402001.02.1.0001,160,332,10,502,0,0
788482_200350_0108Acta0108.jpg,110404004.01.1.0001,291,72,30,393,0,0
788482_201807_0057Acta0057.jpg,110401037.01.1.0001,162,416,13,591,0,0
788482_225092_0114Acta0114.jpg,110405001.03.1.0001,162,439,15,616,0,0
788482_233841_0124Acta0124.jpg,110403003.02.1.0001,203,408,19,630,1,1
788482_283345_0064Acta0064.jpg,110401030.01.1.0001,162,298,16,476,0,0
788482_317341_0038Acta0038.jpg,110401011.01.1.0001,129,352,11,492,0,0
788482_448381_0105Acta0105.jpg,110404001.01.1.0001,215,316,6,537,1,1
788482_452876_0025Acta0025.jpg,110401002.03.1.0001,136,468,14,618,0,0
788482_572836_0095Acta0095.jpg,110404002.01.1.0001,143,266,13,422,0,0
788482_589261_0082Acta0082.jpg,110402005.01.1.0001,122,104,13,239,0,0
788482_604584_0069Acta0069.jpg,110401027.01.1.0001,49,42,1,92,0,0
788482_642041_0060Acta0060.jpg,110401039.01.1.0001,118,190,13,321,0,0
788482_672354_0033Acta0033.jpg,110401002.01.1.0001,138,442,15,595,0,0
788482_716711_0076Acta0076.jpg,110401009.01.1.0001,137,420,11,568,0,0
788482_751341_0072Acta0072.jpg,110401016.01.1.0001,357,133,9,499,0,0
788482_754032_0145Acta0145.jpg,110403005.02.1.0001,183,187,22,392,0,0
788482_818748_0083Acta0083.jpg,110402004.01.1.0001,184,381,27,592,0,0
788482_821963_0070Acta0070.jpg,110401019.01.1.0001,189,170,15,374,0,0
788482_839461_0130Acta0130.jpg,110407008.01.1.0001,186,195,14,395,0,0
788482_858412_0112Acta0112.jpg,110405001.01.1.0001,166,438,12,616,0,0
788482_966840_0077Acta0077.jpg,110401009.02.1.0001,114,436,11,561,1,1
A01950_004959_0366Acta0191.jpg,020601007.03.1.0001,116,351,7,474,0,0
A01950_044223_0258Acta0083.jpg,020101013.04.1.0001,130,336,13,479,1,1
A01950_077184_0507Acta0332.jpg,020102001.02.1.0001,148,343,16,507,0,0
A01950_128477_0479Acta0304.jpg,022001001.01.1.0001,265,328,6,599,0,0
A01950_185109_0342Acta0167.jpg,020201003.02.1.0001,169,309,12,490,0,0
A01950_216174_0313Acta0138.jpg,020801004.01.1.0001,334,263,6,603,0,0
A01950_225557_0386Acta0211.jpg,020601011.03.1.0001,139,278,13,430,0,0
A01950_230360_0419Acta0244.jpg,020601003.01.1.0001,95,300,10,405,1,1
A01950_240565_0309Acta0134.jpg,020803001.01.1.0001,270,258,5,533,0,0
A01950_242396_0241Acta0067.jpg,020101014.02.1.0001,76,279,13,368,0,0
A01950_251396_0322Acta0147.jpg,020802001.02.1.0001,279,335,3,617,0,0
A01950_291740_0242Acta0068.jpg,020101021.02.1.0001,138,396,11,545,0,0
A01950_298278_0346Acta0171.jpg,020201021.01.1.0001,181,223,20,424,0,0
A01950_324269_0426Acta0251.jpg,020101018.03.1.0001,105,380,9,494,0,0
A01950_424685_0379Acta0204.jpg,020601004.02.1.0001,158,353,8,519,0,0
A01950_437518_0387Acta0212.jpg,020601011.02.1.0001,135,268,10,413,0,0
A01950_512482_0392Acta0217.jpg,020601002.01.1.0001,85,393,8,486,0,0
A01950_529956_0245Acta0070.jpg,020101021.01.1.0001,133,386,16,535,0,0
A01950_581140_0470Acta0295.jpg,020101015.03.1.0001,58,343,13,414,0,0
A01950_629609_0316Acta0141.jpg,020801003.01.1.0001,215,266,8,489,0,0
A01950_682746_0445Acta0270.jpg,020101004.01.1.0001,145,311,13,469,0,0
A01950_688991_0372Acta0197.jpg,020601001.02.1.0001,124,323,8,455,0,0
A01950_720012_0324Acta0149.jpg,020201005.02.1.0001,138,291,12,441,0,0
A01950_732222_0364Acta0189.jpg,020601006.02.1.0001,173,343,13,529,0,0
A01950_819604_0448Acta0273.jpg,020101001.02.1.0001,96,421,12,529,0,0
A01950_875599_0377Acta0202.jpg,020601010.01.1.0001,105,329,13,447,0,0
A01950_909415_0449Acta0274.jpg,020101001.01.1.0001,84,394,10,488,0,0
A01950_932170_0502Acta0327.jpg,020101006.05.1.0001,96,347,10,453,0,0
A01950_944654_0403Acta0228.jpg,020201011.01.1.0001,89,70,8,167,0,0
A01950_962689_0380Acta0205.jpg,020601008.02.1.0001,174,348,16,538,0,0
A01950_965187_0368Acta0193.jpg,020601007.01.1.0001,133,330,15,478,0,0
A09535_076233_0936Acta0318.jpg,060304013.01.1.0001,68,329,4,401,0,0
A09535_208482_0959Acta0341.jpg,060304014.02.1.0001,62,348,4,414,1,1
A09535_474438_0999Acta0381.jpg,060306005.03.1.0001,127,288,21,436,0,0
A09535_495043_0831Acta0213.jpg,060301014.01.1.0001,78,247,6,331,0,0
A09535_500596_0980Acta0362.jpg,060303010.02.1.0001,113,428,8,549,0,0
A09535_655231_0919Acta0301.jpg,060301012.01.1.0001,122,342,12,476,1,1
A09535_695909_0918Acta0300.jpg,060304018.01.1.0001,95,193,13,301,0,0
A09535_698424_0951Acta0333.jpg,060304007.01.1.0001,40,400,5,445,0,0
A09535_718914_0938Acta0320.jpg,060304022.01.1.0001,25,265,8,298,0,0
A09535_753874_1062Acta0444.jpg,060303004.03.1.0001,70,331,8,409,0,0
A09535_792884_1042Acta0424.jpg,060303013.02.1.0001,125,394,12,531,0,0
A09535_914181_0850Acta0232.jpg,060301003.04.1.0001,113,394,12,519,0,0
A09535_924747_0823Acta0205.jpg,060301041.01.1.0001,61,130,1,192,0,0
A09535_944584_0832Acta0214.jpg,060301023.01.1.0001,65,417,7,489,0,0
A09535_969653_1033Acta0415.jpg,060303018.02.1.0001,82,380,15,477,0,0
A09535_978380_0843Acta0225.jpg,060301007.02.1.0001,75,256,3,334,0,0
AG8A001761_068111_2024-07-29-0001.jpg,160301010.01.1.0001,132,551,5,688,0,0
AG8A001761_152209_2024-07-29-0003.jpg,160303002.01.1.0001,115,378,10,503,0,0
AG8A001761_298248_2024-07-29-0002.jpg,160301019.02.1.0001,39,375,11,425,0,0
AG8A001761_320015_2024-07-28-0042.jpg,160301016.01.1.0001,93,431,17,541,0,0
AG8A001761_590067_2024-07-28-0057.jpg,160301023.02.1.0001,113,409,12,534,0,0
AG8A001761_607938_2024-07-29-0001.jpg,160301019.03.1.0001,53,359,2,414,0,0
AG8A001761_628719_2024-07-28-0044.jpg,160301016.03.1.0001,99,430,4,533,0,0
AG8A001761_731080_2024-07-28-0041.jpg,160301075.02.1.0001,79,508,14,601,0,0
AG8A001761_833072_2024-07-29-0001.jpg,160301076.01.1.0001,40,231,5,276,0,0
AG8A001761_925383_2024-07-29-0002.jpg,160102001.01.1.0001,228,368,11,607,0,0
AG8A001761_944934_2024-07-28-0043.jpg,160301016.02.1.0001,105,430,7,542,0,0
AG8A003216_670157_2024-07-29-0001.jpg,220103004.01.1.0001,240,277,7,524,0,0
AG8A003216_944401_2024-07-29-0001.jpg,220101020.01.1.0001,163,300,6,469,0,0
AG8A003216_989044_2024-07-29-0001.jpg,220101017.01.1.0001,132,167,3,302,0,0
AG8A003730_992819_2024-07-28-0001.jpg,030301013.03.1.0001,87,369,8,464,0,0
AG8A003757_024254_2024-07-29-0001.jpg,080201048.02.1.0001,162,357,15,534,0,0
AG8A003757_157725_2024-07-29-0001.jpg,080201010.02.1.0001,82,469,6,557,0,0
AG8A003757_271812_2024-07-29-0001.jpg,080701011.03.1.0001,176,365,10,551,0,0
AG8A003757_297929_2024-07-28-0003.jpg,080801001.02.1.0001,147,352,11,510,0,0
AG8A003757_350042_2024-07-29-0001.jpg,080201002.01.1.0001,169,358,20,547,0,0
AG8A003757_548332_2024-07-29-0001.jpg,080201017.01.1.0001,133,299,16,448,0,0
AG8A003757_666060_2024-07-28-0001.jpg,080201020.02.1.0001,166,257,16,439,0,0
AG8A003982_083598_2024-07-28-0002.jpg,120107003.02.1.0001,77,381,6,464,0,0
AG8A004112_190320_2024-07-29-0033.jpg,090804001.01.1.0001,136,375,6,517,0,0
AG8A004112_423286_2024-07-29-0053.jpg,090802006.01.1.0001,60,47,7,114,0,0
AG8A004112_551229_2024-07-29-0032.jpg,090804001.02.1.0001,131,403,14,548,0,0
AG8A004112_736683_2024-07-29-0045.jpg,090803001.01.1.0001,21,140,4,165,0,0
AG8A004164_005639_2024-07-29-0001.jpg,191101001.01.1.0001,168,340,10,518,0,0
AG8A004164_072661_2024-07-29-0001.jpg,191302001.03.1.0001,123,333,5,461,0,0
AG8A004164_177217_2024-07-29-0001.jpg,190706003.01.1.0001,133,360,8,501,0,0
AG8A004164_286202_2024-07-28-0001.jpg,190704007.02.1.0001,116,299,3,418,0,0
AG8A004164_313439_2024-07-29-0001.jpg,190702010.02.1.0001,189,396,9,594,0,0
AG8A004164_362926_2024-07-28-0001.jpg,190701019.03.1.0001,137,390,17,544,0,0
AG8A004164_382996_2024-07-29-0001.jpg,190702009.02.1.0001,53,428,7,488,0,0
AG8A004164_441983_2024-07-29-0001.jpg,191301002.01.1.0001,102,400,5,507,0,0
AG8A004164_457271_2024-07-29-0001.jpg,190602002.01.1.0001,35,102,4,141,0,0
AG8A004164_470469_2024-07-28-0001.jpg,190701001.03.1.0001,97,372,13,482,0,0
AG8A004164_533498_2024-07-29-0001.jpg,190701023.02.1.0001,144,223,9,376,0,0
AG8A004164_552830_2024-07-29-0001.jpg,191302002.02.1.0001,122,360,5,487,0,0
AG8A004164_584527_2024-07-29-0001.jpg,191301001.01.1.0001,92,73,2,167,0,0
AG8A004164_601421_2024-07-29-0001.jpg,190401014.01.1.0001,81,150,4,235,0,0
AG8A004164_685772_2024-07-29-0001.jpg,190103001.02.1.0001,103,344,9,456,0,0
AG8A004164_778264_2024-07-29-0001.jpg,190701009.03.1.0001,108,285,3,396,0,0
AG8A004164_814663_2024-07-29-0001.jpg,191103004.01.1.0001,108,351,3,462,0,0
AG8A004669_008257_2024-07-29-0001.jpg,110202030.01.1.0001,41,336,7,384,0,0
AG8A004669_053782_2024-07-29-0001.jpg,110502017.02.1.0001,131,427,11,569,1,1
AG8A004669_675904_2024-07-29-0001.jpg,110204014.02.1.0001,189,427,26,642,0,0
AG8A004669_891900_2024-07-29-0001.jpg,110202065.02.1.0001,71,487,8,566,0,0
AG8A004669_927971_2024-07-29-0001.jpg,110202047.01.1.0001,107,384,14,505,0,0
AG8A005005_076880_2024-07-29-0001.jpg,050704011.01.1.0001,138,167,4,309,0,0
AG8A005005_467614_2024-07-29-0001.jpg,050501001.02.1.0001,225,361,17,603,0,0
AG8A005009_002719_2024-07-28-0001.jpg,181101007.02.1.0001,73,405,10,488,0,0
AG8A005009_015765_2024-07-28-0003.jpg,181101013.02.1.0001,127,231,3,361,0,0
AG8A005009_082135_2024-07-29-0004.jpg,180101008.01.1.0001,66,450,8,524,0,0
AG8A005009_162290_2024-07-29-0001.jpg,181501003.01.1.0001,70,373,7,450,0,0
AG8A005009_376849_2024-07-29-0002.jpg,182301003.01.1.0001,71,506,6,583,0,0
AG8A005009_491554_2024-07-29-0002.jpg,182301012.01.1.0001,38,255,8,301,0,0
AG8A005009_633047_2024-07-28-0001.jpg,181101002.01.1.0001,78,280,7,365,0,0
AG8A005009_719053_2024-07-29-0001.jpg,181101004.02.1.0001,64,399,3,466,0,0
AG8A005009_796189_2024-07-29-0002.jpg,180101006.01.1.0001,61,443,3,507,0,0
AG8A005009_859396_2024-07-29-0003.jpg,180101006.02.1.0001,51,450,9,510,0,0
AG8A005306_127572_2024-07-29-0001.jpg,091003008.01.1.0001,124,398,10,532,0,0
AG8A005306_180721_2024-07-29-0001.jpg,090501004.01.1.0001,147,349,16,512,0,0
AG8A005306_278393_2024-07-29-0013.jpg,091001002.03.1.0001,143,377,17,537,0,0
AG8A005306_299621_2024-07-29-0022.jpg,091001008.01.1.0001,144,374,17,535,0,0
AG8A005306_314540_2024-07-29-0017.jpg,091003001.01.1.0001,63,389,6,458,0,0
AG8A005306_396185_2024-07-29-0011.jpg,091301004.01.1.0001,129,419,10,558,0,0
AG8A005306_437188_2024-07-29-0001.jpg,092301002.01.1.0001,240,374,18,632,0,0
AG8A005306_619963_2024-07-29-0005.jpg,090501003.02.1.0001,110,379,9,498,0,0
AG8A005306_672270_2024-07-29-0001.jpg,091001039.03.1.0001,123,431,15,569,1,1
AG8A005306_710940_2024-07-29-0009.jpg,091101001.03.1.0001,274,282,14,570,0,0
AG8A005306_722294_2024-07-29-0001.jpg,091002013.02.1.0001,44,428,7,479,1,1
AG8A005306_735073_2024-07-29-0004.jpg,091002005.03.1.0001,91,406,10,507,0,0
AG8A005306_759445_2024-07-29-0001.jpg,091007002.01.1.0001,208,425,20,653,0,0
AG8A005306_792587_2024-07-29-0005.jpg,091102005.01.1.0001,130,177,12,319,0,0
AG8A005306_855674_2024-07-29-0002.jpg,091002004.02.1.0001,86,426,12,524,0,0
AG8A005306_928793_2024-07-29-0004.jpg,091003007.01.1.0001,116,392,14,522,0,0
AG8A005306_964186_2024-07-29-0010.jpg,092301003.02.1.0001,212,321,8,541,0,0
AG8A007777_646872_2024-07-30-0004.jpg,101501001.04.1.0001,203,276,6,485,0,0
AG8A007777_988750_2024-07-29-0022.jpg,100801001.04.1.0001,138,341,16,495,1,1
AG8A007777_990249_2024-07-30-0008.jpg,101501001.05.1.0001,255,335,14,604,0,0
AG8A008553_010928_2024-07-28-0001.jpg,030106001.01.1.0001,228,288,3,519,0,0
AG8A008553_247503_2024-07-28-0001.jpg,030101025.01.1.0001,193,184,10,387,0,0
AG8A008553_334950_2024-07-28-0001.jpg,030101002.03.1.0001,189,418,8,615,0,0
AG8A008553_566722_2024-07-29-0001.jpg,030103003.01.1.0001,52,73,2,127,0,0
AG8A008553_749383_2024-07-28-0001.jpg,030101006.04.1.0001,140,345,3,488,0,0
017911_127069_0114Acta0114.jpg,040201010.01.1.0001,124,390,10,524,1,0
017911_157169_0051Acta0051.jpg,040205009.04.1.0001,166,316,20,502,0,0
017911_164578_0123Acta0123.jpg,040203002.03.1.0001,154,312,13,479,0,0
017911_270223_0026Acta0026.jpg,040201012.04.1.0001,57,386,7,450,0,0
017911_279348_0172Acta0172.jpg,040205012.02.1.0001,156,249,20,425,0,0
017911_334155_0153Acta0153.jpg,040202005.05.1.0001,81,443,13,537,0,0
017911_368157_0133Acta0133.jpg,040203003.06.1.0001,124,297,21,442,0,0
017911_422304_0014Acta0014.jpg,040201003.04.1.0001,180,354,24,558,0,0
017911_430233_0115Acta0115.jpg,040201010.05.1.0001,110,365,12,487,0,0
017911_527057_0076Acta0076.jpg,040202002.02.1.0001,149,371,15,535,0,0
017911_537066_0088Acta0088.jpg,040202001.06.1.0001,135,326,9,470,0,0
017911_659225_0112Acta0112.jpg,040205008.01.1.0001,173,427,28,628,0,0
017911_692017_0128Acta0128.jpg,040203003.01.1.0001,139,347,25,511,0,0
017911_692628_0015Acta0015.jpg,040201003.03.1.0001,170,402,33,605,0,0
017911_766860_0012Acta0012.jpg,040201003.05.1.0001,203,406,21,630,0,0
017911_829278_0072Acta0072.jpg,040201011.04.1.0001,127,452,17,596,0,0
017911_840230_0089Acta0089.jpg,040202001.05.1.0001,154,340,14,508,0,0
018527_060115_0415Acta0320.jpg,060401005.02.1.0001,120,440,12,572,0,0
018527_282237_0412Acta0317.jpg,060401017.01.1.0001,101,481,16,598,0,0
018527_408287_0435Acta0340.jpg,060401011.03.1.0001,79,457,9,545,0,0
018527_416579_0425Acta0330.jpg,060401012.02.1.0001,88,452,6,546,1,0
018527_501320_0486Acta0391.jpg,060401013.05.1.0001,110,455,18,583,0,0
018527_566710_0482Acta0387.jpg,060401001.02.1.0001,60,343,11,414,0,0
018527_844720_0383Acta0289.jpg,060401003.03.1.0001,99,396,15,510,0,0
021223_054429_0601Acta0153.jpg,201201012.01.1.0001,231,294,8,533,0,0
021223_104878_0661Acta0167.jpg,200201015.01.1.0001,156,383,13,552,0,0
021223_148918_0230Acta0075.jpg,200401009.02.1.0001,103,295,10,408,0,0
021223_207947_0195Acta0066.jpg,201001006.01.1.0001,136,444,10,590,0,0
021223_273020_0716Acta0178.jpg,200701011.02.1.0001,226,300,21,547,0,0
021223_297856_0143Acta0048.jpg,201001008.02.1.0001,120,275,17,412,0,0
021223_319493_0250Acta0079.jpg,200401009.03.1.0001,106,341,8,455,0,0
021223_329700_0345Acta0099.jpg,200501012.02.1.0001,130,263,9,402,0,0
021223_340101_0119Acta0040.jpg,200401038.03.1.0001,112,326,15,453,0,0
021223_430938_0547Acta0142.jpg,200202005.01.1.0001,251,292,12,555,0,0
021223_478130_0056Acta0019.jpg,201101003.02.1.0001,121,295,13,429,0,0
021223_569203_0613Acta0156.jpg,201201021.01.1.0001,285,313,14,612,0,0
021223_610307_0367Acta0104.jpg,200101031.01.1.0001,92,36,3,131,0,0
021223_642742_0273Acta0084.jpg,200401016.02.1.0001,111,390,10,511,0,0
021223_684155_0483Acta0128.jpg,201301007.01.1.0001,134,196,11,341,0,0
021223_690299_0155Acta0052.jpg,201001003.02.1.0001,124,370,17,511,0,0
021223_707042_0336Acta0097.jpg,200501009.02.1.0001,293,323,18,634,0,0
021223_727171_0079Acta0025.jpg,201101008.02.1.0001,177,405,6,588,0,0
021223_748776_0205Acta0068.jpg,201001001.03.1.0001,133,374,12,519,0,0
021223_823695_0577Acta0149.jpg,200801005.02.1.0001,156,263,16,435,0,0
021223_838850_0751Acta0185.jpg,200701005.03.1.0001,83,298,11,392,0,0
021223_840513_0321Acta0094.jpg,200501016.02.1.0001,121,301,4,426,0,0
021223_842618_0320Acta0094.jpg,200501001.02.1.0001,55,277,11,343,0,0
021223_879832_0285Acta0086.jpg,200401001.03.1.0001,98,337,8,443,0,0
021223_884028_0747Acta0184.jpg,200701020.01.1.0001,116,397,10,523,0,0
021223_889322_0270Acta0083.jpg,200401007.01.1.0001,101,384,11,496,0,0
021223_926962_0169Acta0057.jpg,201101007.01.1.0001,120,430,14,564,0,0
021223_938602_0197Acta0067.jpg,201001020.02.1.0001,129,214,13,356,0,0
021223_971658_0397Acta0110.jpg,200101015.01.1.0001,169,262,8,439,0,0
021223_985079_0241Acta0077.jpg,200401003.02.1.0001,70,416,9,495,0,0
021257_192265_0113Acta0113.jpg,040701008.02.1.0001,129,257,5,391,0,0
021258_866036_0019Acta0019.jpg,200601008.01.1.0001,91,45,2,138,0,0
021274_263705_2024-07-29-0002.jpg,010112050.01.1.0001,146,315,19,480,0,0
021274_335061_2024-07-29-0005.jpg,010112111.01.1.0001,143,149,14,306,0,0
035927_276031_0193Acta0141.jpg,140401001.01.1.0001,206,402,11,619,0,0
035927_493853_0206Acta0154.jpg,140401003.01.1.0001,186,313,13,512,0,0
035927_521282_0189Acta0137.jpg,140403003.01.1.0001,248,189,2,439,0,0
035927_633783_0131Acta0079.jpg,140502001.01.1.0001,186,335,17,538,0,0
035927_635299_0077Acta0025.jpg,140501001.01.1.0001,201,363,17,581,0,0
035927_715893_0121Acta0069.jpg,140501009.01.1.0001,210,323,14,547,0,0
035927_750237_0098Acta0046.jpg,140501014.02.1.0001,241,229,13,483,0,0
041989_129215_0056Acta0055.jpg,070101009.03.1.0001,182,337,15,534,0,0
041989_372234_0010Acta0009.jpg,070501005.01.1.0001,88,413,8,509,0,0
041989_659855_0013Acta0012.jpg,070501004.03.1.0001,154,353,17,524,0,0
041989_829165_0107Acta0106.jpg,070102007.01.1.0001,61,191,9,261,0,0
041989_929834_0042Acta0041.jpg,070501002.01.1.0001,140,387,13,540,0,0
060551_105659_2024-07-29-0001.jpg,200302008.01.1.0001,132,132,5,269,0,0
151515_033862_2024-07-29-0012.jpg,130301030.03.1.0001,73,336,11,420,1,0
1722286142083.jpg,090301001.02.1.0001,134,522,9,665,0,0
2024-07-28-0002.jpg,240102020.01.1.0001,290,365,22,677,0,0
25384_224661_0169Acta0169.jpg,090701004.01.1.0001,83,233,8,324,0,0
25384_306949_0238Acta0238.jpg,090701003.01.1.0001,126,378,8,512,0,0
25384_470209_0226Acta0226.jpg,090708002.01.1.0001,58,122,1,181,0,0
25384_529375_0232Acta0232.jpg,090704005.01.1.0001,59,71,3,133,0,0
25384_846878_0179Acta0179.jpg,090705001.02.1.0001,110,294,8,412,0,0
25384_855400_0203Acta0203.jpg,090706009.03.1.0001,206,354,12,572,0,0
388421_319249_0383Acta0145.jpg,030602007.01.1.0001,78,43,3,124,0,0
388421_614740_0313Acta0120.jpg,030701020.01.1.0001,129,136,9,274,0,0
388421_847181_0107Acta0045.jpg,030601009.02.1.0001,114,447,6,567,0,0
408106_067624_0160Acta0160.jpg,010101003.02.1.0001,137,382,15,534,0,0
408106_144190_0163Acta0163.jpg,010101003.06.1.0001,111,361,12,484,0,0
408106_146053_0149Acta0149.jpg,010101007.02.1.0001,107,265,14,386,0,0
408106_167074_0252Acta0251.jpg,010105016.02.1.0001,268,375,35,678,0,0
408106_199709_0056Acta0056.jpg,010113011.07.1.0001,68,308,10,386,0,0
408106_203460_0437Acta0390.jpg,240101012.05.1.0001,62,423,11,496,0,0
408106_217235_0077Acta0077.jpg,010113019.02.1.0001,164,284,9,457,1,0
408106_292772_0321Acta0320.jpg,010121008.01.1.0001,97,327,5,429,0,0
408106_297804_0118Acta0118.jpg,010113037.02.1.0001,80,331,14,425,0,0
408106_317055_0113Acta0113.jpg,010113010.03.1.0001,44,255,6,305,0,0
408106_338837_0389Acta0375.jpg,010107028.01.1.0001,158,315,22,495,0,0
408106_340039_0469Acta0398.jpg,240108002.03.1.0001,151,435,13,599,0,0
408106_364690_0488Acta0401.jpg,240107005.02.1.0001,318,254,12,584,0,0
408106_391841_0376Acta0363.jpg,010120008.04.1.0001,95,347,15,457,0,0
408106_431896_0387Acta0373.jpg,010110112.01.1.0001,203,302,20,525,0,0
408106_437514_0195Acta0194.jpg,010106002.04.1.0001,170,285,19,474,0,0
408106_482449_0506Acta0408.jpg,240105011.03.1.0001,155,390,18,563,0,0
408106_536693_0226Acta0225.jpg,010103006.02.1.0001,140,212,15,367,0,0
408106_542710_0494Acta0403.jpg,240107014.03.1.0001,193,315,16,524,0,0
408106_565083_0441Acta0391.jpg,240101012.01.1.0001,54,445,10,509,0,0
408106_608717_0263Acta0262.jpg,010105008.05.1.0001,173,255,17,445,0,0
408106_614939_0309Acta0308.jpg,010121016.01.1.0001,273,308,23,604,0,0
408106_681358_0270Acta0269.jpg,010102008.05.1.0001,124,297,9,430,0,0
408106_774120_0305Acta0304.jpg,010121001.01.1.0001,105,235,17,357,0,0
408106_780752_0162Acta0162.jpg,010101003.03.1.0001,107,371,10,488,0,0
408106_794717_0155Acta0155.jpg,010101008.05.1.0001,112,326,17,455,0,0
408106_852142_0019Acta0019.jpg,010103005.01.1.0001,251,201,9,461,0,0
408106_866827_0346Acta0344.jpg,010110015.02.1.0001,110,281,17,408,0,0
408106_875448_0301Acta0300.jpg,010102015.04.1.0001,99,322,13,434,0,0
408106_918890_0260Acta0259.jpg,010105008.02.1.0001,162,290,14,466,1,0
408106_966271_0039Acta0039.jpg,010113024.05.1.0001,98,332,10,440,0,0
408106_970178_0030Acta0030.jpg,010113016.02.1.0001,104,212,19,335,0,0
408106_978519_0022Acta0022.jpg,010103005.03.1.0001,254,193,11,458,0,0
454356_785216_0748Acta0247.jpg,171401001.01.1.0001,222,223,8,453,0,0
454356_797301_0688Acta0188.jpg,170706002.04.1.0001,337,189,10,536,0,0
454356_863985_0712Acta0211.jpg,170701005.01.1.0001,298,304,7,609,0,0
454356_880144_0751Acta0250.jpg,171401009.02.1.0001,321,207,8,536,0,0
454356_902075_0710Acta0209.jpg,170701004.02.1.0001,350,238,13,601,0,0
454356_905267_0776Acta0275.jpg,170601001.01.1.0001,131,328,6,465,0,0
454356_958943_0733Acta0232.jpg,170704001.03.1.0001,239,179,7,425,0,0
454402_032851_0277Acta0239.jpg,150101008.01.1.0001,105,376,13,494,0,0
454402_068579_0322Acta0284.jpg,150601012.01.1.0001,87,289,11,387,0,0
454402_084922_0555Acta0517.jpg,150601030.02.1.0001,87,224,23,334,0,0
454402_094852_0415Acta0377.jpg,151101004.01.1.0001,129,353,7,489,0,0
454402_126363_0475Acta0437.jpg,151001010.01.1.0001,272,363,11,646,0,0
454402_194920_0318Acta0280.jpg,150601023.03.1.0001,125,344,18,487,0,0
454402_299038_0289Acta0251.jpg,150402004.03.1.0001,49,373,5,427,0,0
454402_350309_0330Acta0292.jpg,150601018.02.1.0001,111,323,16,450,0,0
454402_409186_0499Acta0461.jpg,151102004.03.1.0001,106,306,3,415,0,0
454402_450578_0306Acta0268.jpg,150401009.01.1.0001,58,242,4,304,0,0
454402_682299_0414Acta0376.jpg,151101004.03.1.0001,113,410,19,542,0,0
454402_855154_0406Acta0368.jpg,151102010.01.1.0001,146,255,11,412,0,0
454402_865950_0556Acta0518.jpg,150601030.03.1.0001,88,242,8,338,0,0
454402_912297_0287Acta0249.jpg,150402004.04.1.0001,37,369,4,410,0,0
454417_605848_0361Acta0105.jpg,060604001.01.1.0001,214,285,15,514,0,0
454417_758310_0376Acta0120.jpg,060602001.01.1.0001,122,114,5,241,0,0
454446_107470_0094Acta0091.jpg,010108028.02.1.0001,157,382,16,555,0,0
454446_114827_0154Acta0125.jpg,010120018.01.1.0001,115,270,13,398,0,0
454446_164171_0038Acta0035.jpg,010120025.04.1.0001,69,313,11,393,0,0
454446_175044_0170Acta0136.jpg,010119005.01.1.0001,138,361,21,520,0,0
454446_277325_0127Acta0113.jpg,010108044.01.1.0001,289,164,32,485,0,0
454446_292435_0045Acta0042.jpg,010120014.03.1.0001,128,339,17,484,0,0
454446_346822_0019Acta0016.jpg,010120022.01.1.0001,82,336,4,422,0,0
454446_453572_0277Acta0206.jpg,010110207.02.1.0001,132,306,23,461,0,0
454446_464084_0212Acta0158.jpg,010114040.05.1.0001,195,369,22,586,1,0
454446_482768_0090Acta0087.jpg,010108047.01.1.0001,173,299,13,485,0,0
454446_536000_0211Acta0158.jpg,010114036.01.1.0001,187,248,24,459,1,0
454446_545656_0299Acta0220.jpg,010102017.03.1.0001,147,380,19,546,0,0
454446_590758_0135Acta0114.jpg,010108077.02.1.0001,189,270,18,477,0,0
454446_672419_0068Acta0065.jpg,010108010.01.1.0001,255,337,28,620,0,0
454446_756521_0180Acta0140.jpg,010119001.01.1.0001,92,297,13,402,0,0
454446_834519_0125Acta0112.jpg,010108007.02.1.0001,208,357,25,590,0,0
454446_931370_0147Acta0118.jpg,010108027.01.1.0001,202,364,16,582,0,0
454446_964961_0214Acta0159.jpg,010114040.03.1.0001,201,357,22,580,0,0
454450_004927_0114Acta0113.jpg,040101020.02.1.0001,214,439,19,672,0,0
454450_013373_0191Acta0190.jpg,040104019.03.1.0001,121,403,11,535,0,0
454450_027476_0216Acta0215.jpg,040104001.03.1.0001,110,295,12,417,0,0
454450_043207_0198Acta0197.jpg,040104007.02.1.0001,51,212,7,270,0,0
454450_126580_0133Acta0132.jpg,040101012.02.1.0001,99,409,12,520,0,0
454450_135289_0150Acta0149.jpg,040101006.05.1.0001,91,384,14,489,0,0
454450_142899_0112Acta0111.jpg,040106019.01.1.0001,70,282,9,361,0,0
454450_146807_0045Acta0044.jpg,040103014.02.1.0001,67,425,8,500,0,0
454450_186437_0117Acta0116.jpg,040101024.02.1.0001,109,341,10,460,0,0
454450_228404_0286Acta0285.jpg,040103013.01.1.0001,127,365,16,508,0,0
454450_246150_0053Acta0052.jpg,040103006.02.1.0001,37,314,3,354,0,0
454450_345632_0254Acta0253.jpg,040105015.03.1.0001,138,262,17,417,0,0
454450_386201_0264Acta0263.jpg,040105019.02.1.0001,104,301,15,420,0,0
454450_441982_0233Acta0232.jpg,040105004.01.1.0001,170,365,24,559,0,0
454450_458807_0054Acta0053.jpg,040103006.03.1.0001,26,327,4,357,0,0
454450_540380_0278Acta0277.jpg,040103010.03.1.0001,124,357,24,505,0,0
454450_541534_0314Acta0313.jpg,040103005.05.1.0001,57,377,11,445,0,0
45459339_505946_0355Acta0114.jpg,140706017.02.1.0001,127,391,8,526,0,0
459339_529170_0225Acta0051.jpg,140709008.02.1.0001,120,409,12,541,0,0
459339_567771_0605Acta0224.jpg,140707005.01.1.0001,162,179,7,348,0,0
459339_739347_0249Acta0068.jpg,140710029.01.1.0001,89,331,3,423,0,0
459339_758048_0545Acta0206.jpg,140710003.02.1.0001,115,392,11,518,0,0
459339_824918_0395Acta0135.jpg,140709009.02.1.0001,134,427,13,574,0,0
459339_851548_0542Acta0205.jpg,140710030.02.1.0001,85,405,13,503,0,0
459339_933099_0687Acta0250.jpg,140706006.01.1.0001,220,349,14,583,0,0
459339_945289_0285Acta0082.jpg,140710007.02.1.0001,89,377,8,474,1,0
459339_973391_0325Acta0100.jpg,140704003.02.1.0001,119,196,14,329,0,0
462591_092954_0140Acta0127.jpg,021302003.03.1.0001,118,353,11,482,0,0
462591_172442_0255Acta0242.jpg,021301087.03.1.0001,145,339,12,496,0,0
462591_257974_0290Acta0277.jpg,021301014.03.1.0001,122,330,17,469,0,0
462591_347284_0289Acta0276.jpg,021301014.04.1.0001,120,364,16,500,0,0
462591_484825_0301Acta0288.jpg,021302016.05.1.0001,91,432,8,531,0,0
462591_645911_0305Acta0292.jpg,021301098.01.1.0001,175,251,17,443,0,0
462591_809288_0123Acta0110.jpg,021302013.04.1.0001,100,344,9,453,0,0
462591_810106_0093Acta0080.jpg,021501017.01.1.0001,107,308,15,430,0,0
462591_887407_0067Acta0054.jpg,021501001.01.1.0001,71,258,15,344,0,0
462591_941467_0057Acta0044.jpg,021302010.01.1.0001,129,370,14,513,0,0
465290_639990_0438Acta0153.jpg,130901033.01.1.0001,46,219,3,268,1,0
474306_034082_0201Acta0103.jpg,140101004.01.1.0001,138,292,10,440,0,0
474306_544550_0206Acta0106.jpg,140101001.02.1.0001,154,360,7,521,0,0
474306_559254_0194Acta0099.jpg,140101002.02.1.0001,140,376,4,520,0,0
474306_613854_0187Acta0094.jpg,140303003.01.1.0001,190,162,4,356,0,0
474306_646292_0123Acta0058.jpg,140801006.01.1.0001,202,99,6,307,0,0
474306_722560_0154Acta0085.jpg,140305001.02.1.0001,164,203,11,378,0,0
474306_762016_0181Acta0092.jpg,140302002.01.1.0001,246,266,14,526,0,0
474306_914102_0212Acta0110.jpg,140101008.01.1.0001,279,229,16,524,0,0
476204_006684_0075Acta0025.jpg,060108014.03.1.0001,110,381,17,508,0,0
476204_033661_0299Acta0122.jpg,060106015.02.1.0001,37,342,4,383,0,0
476204_050970_0285Acta0117.jpg,060106012.04.1.0001,72,337,11,420,1,0
476204_088026_0148Acta0055.jpg,060107009.03.1.0001,38,315,4,357,0,0
476204_313892_0271Acta0110.jpg,060106005.05.1.0001,67,321,5,393,0,0
476204_398799_0145Acta0054.jpg,060107001.02.1.0001,55,425,9,489,0,0
476204_425022_0435Acta0185.jpg,060105016.03.1.0001,123,390,16,529,0,0
476204_438292_0131Acta0049.jpg,060107007.02.1.0001,41,374,8,423,0,0
476204_461706_0342Acta0143.jpg,060103007.03.1.0001,171,386,18,575,0,0
476204_492934_0301Acta0122.jpg,060106015.04.1.0001,50,311,8,369,1,0
476204_676114_0143Acta0053.jpg,060107008.05.1.0001,56,347,4,407,0,0
476204_740211_0108Acta0036.jpg,060108011.03.1.0001,97,395,13,505,0,0
476204_765709_0092Acta0030.jpg,060108004.02.1.0001,49,333,11,393,0,0
476204_793419_0140Acta0052.jpg,060107008.03.1.0001,41,335,10,386,0,0
476204_797216_0197Acta0071.jpg,060101018.02.1.0001,110,335,6,451,0,0
476204_824761_0077Acta0025.jpg,060108014.05.1.0001,102,398,8,508,0,0
476204_832507_0280Acta0114.jpg,060106011.02.1.0001,38,374,8,420,0,0
476204_924694_0196Acta0071.jpg,060101018.01.1.0001,117,325,8,450,0,0
480196_017944_0594Acta0429.jpg,210203001.02.1.0001,89,272,6,367,0,0
480196_024055_0405Acta0378.jpg,211004003.02.1.0001,82,208,0,290,0,0
480196_056629_0136Acta0135.jpg,210507007.03.1.0001,59,316,1,376,1,0
480196_064627_0640Acta0437.jpg,210516008.02.1.0001,97,349,7,453,0,0
480196_101309_0046Acta0045.jpg,210503009.05.1.0001,146,373,7,526,0,0
480196_126027_0212Acta0211.jpg,210605016.01.1.0001,150,231,8,389,0,0
480196_149848_0647Acta0438.jpg,210506005.04.1.0001,41,302,2,345,0,0
480196_174548_0696Acta0446.jpg,210506004.09.1.0001,31,285,6,322,0,0
480196_178472_0317Acta0315.jpg,211802013.03.1.0001,99,297,10,406,0,0
480196_203256_0346Acta0344.jpg,210513002.01.1.0001,105,355,14,474,0,0
480196_211939_0453Acta0396.jpg,210511005.04.1.0001,114,366,7,487,0,0
480196_227673_0066Acta0065.jpg,210503036.02.1.0001,75,342,4,421,0,0
488168_083158_0030Acta0030.jpg,091401004.03.1.0001,64,400,9,473,0,0
488168_128879_0073Acta0073.jpg,090301005.01.1.0001,186,379,10,575,0,0
488168_152085_0072Acta0072.jpg,090301003.01.1.0001,115,239,7,361,0,0
488168_220143_0059Acta0059.jpg,090304002.01.1.0001,157,180,7,344,0,0
488168_495024_0114Acta0114.jpg,090901002.03.1.0001,105,463,8,576,0,0
488168_803791_0068Acta0068.jpg,090304005.01.1.0001,156,272,17,445,0,0
489338_038207_0027Acta0027.jpg,041302035.01.1.0001,138,167,15,320,0,0
489338_039657_0072Acta0072.jpg,041302005.02.1.0001,102,331,19,452,0,0
489338_049971_0102Acta0102.jpg,041302001.01.1.0001,105,339,17,461,0,0
489338_066482_0099Acta0099.jpg,041302008.01.1.0001,128,318,14,460,0,0
489338_066557_0252Acta0252.jpg,040107007.05.1.0001,141,354,11,506,0,0
489338_095406_0141Acta0141.jpg,041302015.03.1.0001,109,350,15,474,0,0
489338_183695_0203Acta0203.jpg,040108007.01.1.0001,172,346,29,547,0,0
489338_212733_0090Acta0090.jpg,041301007.03.1.0001,76,365,15,456,0,0
489338_227312_0056Acta0056.jpg,040107014.01.1.0001,119,369,10,498,0,0
489338_286861_0170Acta0170.jpg,040108005.01.1.0001,134,344,9,487,0,0
489338_336858_0215Acta0215.jpg,040108043.01.1.0001,166,255,8,429,1,0
489338_394814_0008Acta0008.jpg,041301010.05.1.0001,62,404,12,478,0,0
489338_399344_0077Acta0077.jpg,041302032.02.1.0001,172,288,15,475,0,0
489338_425402_0098Acta0098.jpg,041302008.03.1.0001,126,375,19,520,0,0
489338_460105_0088Acta0088.jpg,041301007.05.1.0001,76,345,12,433,1,0
489338_468608_0111Acta0111.jpg,041301006.03.1.0001,166,419,15,600,0,0
489338_536257_0144Acta0144.jpg,040107012.01.1.0001,60,359,6,425,0,0
489338_613744_0218Acta0218.jpg,040108011.01.1.0001,151,283,17,451,0,0
489338_626319_0110Acta0110.jpg,041301006.02.1.0001,170,403,19,592,1,0
489338_776068_0276Acta0276.jpg,041801005.01.1.0001,343,204,14,561,0,0
489338_805177_0240Acta0240.jpg,040107018.01.1.0001,148,355,11,514,0,0
489338_821809_0146Acta0146.jpg,040107023.01.1.0001,64,165,10,239,0,0
489338_912392_0155Acta0155.jpg,040108014.02.1.0001,102,443,14,559,0,0
489338_946773_0026Acta0026.jpg,041302039.01.1.0001,158,224,22,404,0,0
492227_276405_0047Acta0047.jpg,060201012.03.1.0001,131,295,7,433,0,0
492227_512047_0019Acta0019.jpg,060201011.02.1.0001,99,339,8,446,0,0
492426_257675_0334Acta0124.jpg,121603001.02.1.0001,84,429,5,518,0,0
492426_942975_0402Acta0172.jpg,121003003.01.1.0001,143,112,3,258,0,0
492677_391900_0451Acta0083.jpg,051001016.02.1.0001,85,296,9,390,0,0
492677_607584_0532Acta0128.jpg,050401006.02.1.0001,77,390,11,478,0,0
492677_617916_0623Acta0181.jpg,051201004.01.1.0001,28,110,1,139,0,0
492677_760173_0526Acta0123.jpg,050401005.01.1.0001,58,453,4,515,0,0
492677_797265_0486Acta0098.jpg,051003001.01.1.0001,62,416,3,481,0,0
492677_869266_0546Acta0135.jpg,050401004.02.1.0001,63,536,11,610,0,0
493518_001899_0400Acta0400.jpg,180601005.04.1.0001,72,434,14,520,0,0
493518_085469_0415Acta0415.jpg,180601004.02.1.0001,89,358,12,459,0,0
493518_445007_0191Acta0191.jpg,180601026.01.1.0001,116,387,11,514,0,0
493518_535096_0210Acta0210.jpg,180601016.03.1.0001,55,374,11,440,1,0
493518_566587_0396Acta0396.jpg,180601008.02.1.0001,93,423,11,527,0,0
493518_718600_0463Acta0463.jpg,180201016.02.1.0001,49,287,3,339,0,0
493518_770265_0317Acta0317.jpg,181601004.02.1.0001,48,299,4,351,0,0
493518_903208_0387Acta0387.jpg,180601021.01.1.0001,66,375,6,447,0,0
493518_981832_0194Acta0194.jpg,180601022.01.1.0001,84,392,8,484,0,0
494985_020584_0354Acta0117.jpg,130902019.01.1.0001,68,315,3,386,0,0
494985_077258_0390Acta0153.jpg,130901065.05.1.0001,140,306,16,462,0,0
494985_093691_0365Acta0128.jpg,130902011.01.1.0001,166,284,5,455,0,0
494985_181451_0423Acta0186.jpg,130901087.03.1.0001,220,337,31,588,0,0
494985_265767_0340Acta0103.jpg,130901003.05.1.0001,18,346,5,369,0,0
494985_419384_0343Acta0106.jpg,130901003.07.1.0001,16,348,2,366,0,0
494985_424476_0301Acta0065.jpg,130902015.03.1.0001,51,364,9,424,0,0
494985_499197_0316Acta0079.jpg,130902024.02.1.0001,45,306,8,359,0,0
494985_530356_0317Acta0080.jpg,130902024.07.1.0001,57,337,10,404,0,0
021274_661439_2024-07-29-0006.jpg,010118044.01.1.0001,56,99,4,159,0,0
021274_787413_2024-07-29-0004.jpg,010117020.04.1.0001,144,423,27,594,0,0
021274_853092_2024-07-29-0001.jpg,010112036.03.1.0001,217,323,26,566,0,0
021274_951196_2024-07-29-0004.jpg,010117087.01.1.0001,93,92,6,191,0,0
033257_048606_0253Acta0245.jpg,010122006.02.1.0001,40,221,9,270,0,0
033257_176915_0349Acta0341.jpg,010115007.03.1.0001,150,381,15,546,0,0
033257_331885_0137Acta0129.jpg,010107007.01.1.0001,160,258,22,440,0,0
033257_382449_0023Acta0015.jpg,010109004.01.1.0001,157,319,17,493,0,0
033257_419570_0102Acta0094.jpg,010107026.02.1.0001,241,243,12,496,0,0
033257_429064_0053Acta0045.jpg,010115009.07.1.0001,39,336,2,377,0,0
033257_496953_0312Acta0304.jpg,010115006.02.1.0001,188,294,23,505,0,0
033257_515832_0076Acta0068.jpg,010115015.03.1.0001,61,388,6,455,0,0
033257_528003_0046Acta0038.jpg,010109014.01.1.0001,81,69,2,152,0,0
033257_567445_0244Acta0236.jpg,010122012.01.1.0001,58,245,1,304,0,0
033257_580532_0248Acta0240.jpg,010122041.02.1.0001,173,263,25,461,0,0
033257_588732_0202Acta0194.jpg,010107023.02.1.0001,163,356,19,538,0,0
033257_591447_0289Acta0281.jpg,010122014.03.1.0001,76,287,12,375,0,0
033257_596910_0168Acta0160.jpg,010107021.06.1.0001,159,359,25,543,0,0
033257_612205_0262Acta0254.jpg,010122008.04.1.0001,109,360,14,483,1,0
033257_623366_0101Acta0093.jpg,010107026.03.1.0001,244,264,20,528,0,0
033257_656570_0028Acta0020.jpg,010109004.05.1.0001,149,323,18,490,0,0
033257_666276_0045Acta0037.jpg,010109012.01.1.0001,97,140,4,241,0,0
033257_678968_0258Acta0250.jpg,010122068.03.1.0001,83,362,8,453,0,0
033257_679029_0089Acta0081.jpg,010115016.02.1.0001,73,419,8,500,0,0
033257_694127_0037Acta0029.jpg,010109006.03.1.0001,93,314,15,422,0,0
033257_719629_0153Acta0145.jpg,010107008.02.1.0001,255,271,26,552,0,0
033257_728176_0116Acta0108.jpg,010107051.01.1.0001,241,258,28,527,0,0
033257_735236_0294Acta0286.jpg,010122002.02.1.0001,136,228,10,374,0,0
033257_745525_0274Acta0266.jpg,010122013.06.1.0001,52,396,14,462,0,0
033257_761086_0195Acta0187.jpg,010107010.06.1.0001,166,312,12,490,0,0
033257_767403_0105Acta0097.jpg,010107006.02.1.0001,189,248,26,463,0,0
033257_777806_0095Acta0087.jpg,010107027.01.1.0001,197,363,39,599,0,0
033257_789013_0320Acta0312.jpg,010115029.01.1.0001,165,208,14,387,0,0
033257_802497_0245Acta0237.jpg,010122029.03.1.0001,170,306,19,495,0,0
033257_815898_0181Acta0173.jpg,010107018.03.1.0001,168,362,23,553,0,0
033257_832078_0215Acta0207.jpg,010122043.01.1.0001,60,311,10,381,0,0
033257_835592_0143Acta0135.jpg,010107024.02.1.0001,115,360,17,492,0,0
033257_927420_0025Acta0017.jpg,010109004.03.1.0001,153,349,15,517,0,0
033257_929718_0315Acta0307.jpg,010115002.01.1.0001,228,302,11,541,1,0
033257_938013_0142Acta0134.jpg,010107024.01.1.0001,120,388,17,525,0,0
033257_954897_0303Acta0295.jpg,010122011.01.1.0001,79,339,3,421,0,0
033257_984920_0275Acta0267.jpg,010122013.05.1.0001,48,360,5,413,0,0
035927_098503_0085Acta0033.jpg,140501002.01.1.0001,203,362,20,585,0,0
408106_988412_0487Acta0401.jpg,240107017.01.1.0001,181,378,10,569,0,0
417922_031913_0236Acta0224.jpg,150303002.01.1.0001,138,139,7,284,0,0
417922_117688_0159Acta0147.jpg,150501004.01.1.0001,118,344,10,472,0,0
417922_176486_0166Acta0154.jpg,150501007.02.1.0001,147,373,5,525,0,0
417922_227519_0190Acta0178.jpg,150202014.01.1.0001,196,209,20,425,0,0
417922_337661_0131Acta0119.jpg,150201010.02.1.0001,114,312,15,441,0,0
417922_388988_0249Acta0237.jpg,150303003.01.1.0001,106,168,6,280,0,0
417922_486783_0234Acta0222.jpg,150301003.02.1.0001,124,293,17,434,0,0
417922_550460_0197Acta0185.jpg,150201005.01.1.0001,138,446,17,601,0,0
417922_577205_0252Acta0240.jpg,150303001.02.1.0001,106,392,11,509,0,0
417922_709145_0187Acta0175.jpg,150202003.02.1.0001,122,232,19,373,0,0
417922_905296_0276Acta0264.jpg,150201006.02.1.0001,151,279,15,445,0,0
441267_578956_0146Acta0146.jpg,091503002.01.1.0001,195,285,12,492,0,0
441267_830784_0074Acta0074.jpg,091201002.01.1.0001,84,485,8,577,1,0
441267_882483_0130Acta0130.jpg,091501003.02.1.0001,76,318,9,403,0,0
443074_000676_0157Acta0157.jpg,130501017.02.1.0001,267,308,27,602,0,0
443074_164030_0491Acta0491.jpg,131001016.02.1.0001,146,320,6,472,0,0
443074_212183_0488Acta0488.jpg,131001009.03.1.0001,87,380,14,481,0,0
443074_276420_0453Acta0453.jpg,131002001.01.1.0001,308,228,16,552,0,0
443074_389810_0499Acta0499.jpg,131001001.04.1.0001,136,335,15,486,0,0
443074_400312_0428Acta0428.jpg,131001015.02.1.0001,288,262,32,582,1,0
443074_430252_0227Acta0227.jpg,130501038.01.1.0001,246,198,23,467,0,0
443074_447167_0171Acta0171.jpg,130501028.02.1.0001,231,223,12,466,0,0
443074_488814_0325Acta0325.jpg,131201018.01.1.0001,254,307,24,585,0,0
443074_505749_0297Acta0297.jpg,131201039.01.1.0001,88,234,10,332,0,0
443074_631405_0381Acta0381.jpg,131202002.02.1.0001,177,248,14,439,1,0
443074_744946_0448Acta0448.jpg,131001016.03.1.0001,111,323,14,448,0,0
443074_817655_0218Acta0218.jpg,130501023.05.1.0001,231,264,34,529,0,0
443074_819888_0386Acta0386.jpg,131201003.04.1.0001,194,266,19,479,0,0
443074_866002_0256Acta0256.jpg,130503006.01.1.0001,421,266,20,707,0,0
443074_880362_0374Acta0374.jpg,131202011.01.1.0001,203,141,16,360,0,0
443074_901980_0273Acta0273.jpg,130501036.02.1.0001,243,229,17,489,0,0
443074_913317_0350Acta0350.jpg,131201001.02.1.0001,108,348,11,467,0,0
443074_918301_0320Acta0320.jpg,131201019.01.1.0001,201,236,24,461,0,0
443074_962646_0462Acta0462.jpg,131002008.02.1.0001,179,264,14,457,0,0
454356_055541_0747Acta0246.jpg,171401016.01.1.0001,354,109,6,469,0,0
454356_066820_0781Acta0280.jpg,170601002.02.1.0001,98,320,9,427,0,0
454356_085163_0771Acta0270.jpg,170601015.01.1.0001,231,305,12,548,0,0
454356_204277_0783Acta0282.jpg,170601011.01.1.0001,108,272,7,387,0,0
454356_490816_0755Acta0254.jpg,171401004.02.1.0001,302,111,14,427,0,0
454356_568969_0788Acta0287.jpg,171502001.02.1.0001,290,369,18,677,0,0
454356_763329_0762Acta0261.jpg,170601020.01.1.0001,111,164,4,279,0,0
454450_616175_0316Acta0315.jpg,040104011.01.1.0001,84,430,5,519,0,0
454450_639767_0246Acta0245.jpg,040105011.01.1.0001,161,433,15,609,0,0
454450_736219_0063Acta0062.jpg,040105016.03.1.0001,73,331,7,411,0,0
454450_769553_0120Acta0119.jpg,040103003.04.1.0001,174,438,22,634,0,0
454450_788978_0130Acta0129.jpg,040101013.03.1.0001,50,410,7,467,0,0
454450_805448_0109Acta0108.jpg,040106008.02.1.0001,42,358,10,410,0,0
454450_832553_0144Acta0143.jpg,040101009.05.1.0001,120,413,14,547,0,0
454450_930254_0090Acta0089.jpg,040106001.03.1.0001,103,387,8,498,0,0
454455_021590_0025Acta0020.jpg,060501007.01.1.0001,135,473,14,622,0,0
454455_581400_0055Acta0030.jpg,061001001.06.1.0001,110,413,14,537,0,0
454455_702171_0020Acta0017.jpg,060501004.01.1.0001,143,483,17,643,0,0
454495_030785_0323Acta0263.jpg,130402008.03.1.0001,250,258,28,536,0,0
454495_040273_0311Acta0251.jpg,130701044.01.1.0001,194,231,20,445,0,0
454495_048750_0282Acta0222.jpg,131502005.02.1.0001,149,144,14,307,0,0
454495_056042_0247Acta0187.jpg,130402015.01.1.0001,181,328,18,527,0,0
454495_060293_0237Acta0177.jpg,130402004.04.1.0001,231,294,19,544,0,0
454495_073834_0229Acta0169.jpg,130401004.01.1.0001,182,347,19,548,0,0
454495_127578_0389Acta0327.jpg,130701025.01.1.0001,246,274,26,546,0,0
454495_305367_0223Acta0164.jpg,130401021.02.1.0001,205,245,29,479,0,0
454495_415353_0421Acta0359.jpg,130701006.01.1.0001,186,310,20,516,0,0
454495_430317_0225Acta0165.jpg,130401021.01.1.0001,204,257,20,481,0,0
454495_548696_0411Acta0349.jpg,130701031.01.1.0001,169,93,7,269,0,0
454495_596718_0317Acta0257.jpg,130401024.01.1.0001,252,285,21,558,0,0
454495_665382_0449Acta0387.jpg,130402002.01.1.0001,212,360,19,591,0,0
454495_745677_0412Acta0350.jpg,130701017.03.1.0001,316,195,15,526,0,0
454495_968448_0234Acta0174.jpg,130402009.05.1.0001,202,286,14,502,0,0
459099_613708_0014Acta0014.jpg,130101001.01.1.0001,182,326,12,520,0,0
459339_011311_0686Acta0249.jpg,140708018.03.1.0001,160,289,20,469,0,0
459339_105357_0213Acta0039.jpg,140709002.03.1.0001,139,319,15,473,0,0
459339_130824_0340Acta0108.jpg,140706007.03.1.0001,165,348,8,521,0,0
459339_161831_0244Acta0066.jpg,140710014.03.1.0001,125,415,9,549,0,0
459339_181402_0248Acta0067.jpg,140710006.03.1.0001,93,294,7,394,0,0
459339_258550_0328Acta0101.jpg,140706019.03.1.0001,146,349,10,505,0,0
459339_280439_0313Acta0095.jpg,140710005.01.1.0001,147,426,10,583,0,0
459339_328281_0251Acta0068.jpg,140710029.03.1.0001,103,308,3,414,0,0
459339_333777_0635Acta0231.jpg,140902010.01.1.0001,222,232,10,464,0,0
459339_420061_0315Acta0095.jpg,140710005.03.1.0001,160,433,11,604,0,0
459339_427671_0288Acta0083.jpg,140710019.01.1.0001,64,403,4,471,0,0
459339_438051_0405Acta0140.jpg,140708002.03.1.0001,118,296,15,429,0,0
459339_461347_0411Acta0143.jpg,140708005.01.1.0001,198,334,11,543,0,0
459339_473894_0184Acta0022.jpg,140706035.02.1.0001,238,279,10,527,0,0
459339_505946_0355Acta0114.jpg,140706017.02.1.0001,127,391,8,526,0,0
480196_249201_0382Acta0371.jpg,210513012.06.1.0001,97,315,5,417,0,0
480196_285957_0645Acta0438.jpg,210506005.02.1.0001,46,297,6,349,0,0
480196_324879_0419Acta0383.jpg,211003001.01.1.0001,110,409,3,522,0,0
480196_356263_0318Acta0316.jpg,211802013.02.1.0001,90,276,15,381,0,0
480196_496335_0192Acta0191.jpg,210202005.03.1.0001,100,241,4,345,0,0
480196_516222_0454Acta0396.jpg,210511005.01.1.0001,91,336,6,433,0,0
480196_550646_0552Acta0421.jpg,210514020.01.1.0001,54,345,3,402,0,0
480196_560176_0220Acta0219.jpg,210605008.03.1.0001,195,366,4,565,0,0
480196_570833_0048Acta0047.jpg,210503002.04.1.0001,92,316,11,419,0,0
480196_587885_0349Acta0347.jpg,210513002.04.1.0001,87,351,13,451,0,0
480196_671979_0027Acta0026.jpg,210503013.03.1.0001,104,417,8,529,0,0
480196_680868_0614Acta0434.jpg,210516013.03.1.0001,87,294,5,386,0,0
480196_683893_0040Acta0039.jpg,210503028.01.1.0001,60,245,1,306,0,0
480196_686718_0541Acta0420.jpg,210518019.01.1.0001,150,125,2,277,0,0
480196_729107_0561Acta0423.jpg,210514020.02.1.0001,58,348,6,412,0,0
480196_752884_0369Acta0367.jpg,210513034.03.1.0001,123,305,6,434,0,0
480196_759557_0065Acta0064.jpg,210503036.01.1.0001,78,342,5,425,0,0
480196_785998_0324Acta0322.jpg,211802014.03.1.0001,63,352,9,424,0,0
480196_836884_0373Acta0370.jpg,210513050.01.1.0001,96,359,7,462,0,0
480196_865978_0181Acta0180.jpg,210202016.01.1.0001,87,103,2,192,0,0
480196_875955_0064Acta0063.jpg,210503022.04.1.0001,136,364,11,511,1,0
480196_885883_0401Acta0377.jpg,211004002.01.1.0001,120,413,4,537,0,0
480196_907700_0683Acta0442.jpg,210506009.04.1.0001,88,328,8,424,0,0
480196_911197_0599Acta0430.jpg,210204002.02.1.0001,126,277,2,405,0,0
480196_914717_0039Acta0038.jpg,210503021.01.1.0001,103,333,2,438,1,0
480196_934502_0432Acta0388.jpg,211005008.02.1.0001,57,332,2,391,0,0
480196_944233_0130Acta0129.jpg,210507009.03.1.0001,57,319,7,383,0,0
480196_955238_0628Acta0436.jpg,210516029.01.1.0001,116,73,8,197,0,0
480196_959038_0487Acta0404.jpg,210511009.04.1.0001,66,347,8,421,0,0
480196_968866_0485Acta0404.jpg,210511009.02.1.0001,80,316,2,398,0,0
480196_978146_0331Acta0329.jpg,210513046.01.1.0001,147,240,7,394,0,0
480196_980949_0179Acta0178.jpg,210202007.01.1.0001,142,289,10,441,0,0
481317_005878_0239Acta0067.jpg,110801015.01.1.0001,110,67,3,180,0,0
481317_303575_0074Acta0020.jpg,110301002.04.1.0001,77,357,8,442,0,0
481317_403438_0079Acta0023.jpg,110307002.02.1.0001,119,333,12,464,0,0
481317_406338_0096Acta0030.jpg,110301001.01.1.0001,155,463,18,636,0,0
481317_604090_0190Acta0056.jpg,110803009.01.1.0001,425,181,16,622,0,0
481317_674857_0179Acta0054.jpg,110302006.01.1.0001,156,235,10,401,0,0
481317_709967_0095Acta0029.jpg,110304006.01.1.0001,78,146,6,230,0,0
481317_775899_0211Acta0061.jpg,110801032.01.1.0001,139,160,7,306,0,0
481317_823279_0185Acta0055.jpg,110302005.01.1.0001,156,212,4,372,0,0
481317_891943_0101Acta0031.jpg,110306008.01.1.0001,184,354,19,557,0,0
494985_588235_0296Acta0060.jpg,130902001.03.1.0001,43,339,8,390,0,0
494985_627601_0342Acta0105.jpg,130901003.03.1.0001,30,341,5,376,0,0
494985_887414_0285Acta0049.jpg,130902008.01.1.0001,56,301,6,363,0,0
494985_899514_0326Acta0089.jpg,130905006.02.1.0001,214,369,17,600,0,0
494985_918754_0370Acta0133.jpg,130902020.03.1.0001,116,300,9,425,0,0
494985_952744_0286Acta0050.jpg,130902021.01.1.0001,55,300,16,371,0,0
494985_975992_0283Acta0047.jpg,130902025.01.1.0001,144,319,15,478,0,0
494985_994111_0363Acta0126.jpg,130901127.01.1.0001,139,186,7,332,0,0
605304_000046_0620Acta0619.jpg,070601023.02.1.0001,146,272,7,425,0,0
605304_078813_0634Acta0633.jpg,070601009.01.1.0001,154,335,8,497,0,0
605304_338461_0646Acta0645.jpg,070705008.04.1.0001,142,399,19,560,0,0
605304_357983_0577Acta0576.jpg,070602005.01.1.0001,179,193,9,381,0,0
605304_462744_0655Acta0654.jpg,070704005.01.1.0001,137,376,15,528,0,0
605304_466167_0593Acta0592.jpg,070601011.01.1.0001,131,324,23,478,0,0
605304_466460_0548Acta0547.jpg,070704008.03.1.0001,232,299,13,544,0,0
605304_494244_0557Acta0556.jpg,070704018.01.1.0001,112,282,12,406,0,0
605304_500056_0556Acta0555.jpg,070706001.01.1.0001,145,289,4,438,0,0
605304_544913_0521Acta0520.jpg,070704007.04.1.0001,160,413,23,596,0,0
605304_617681_0509Acta0508.jpg,070705014.01.1.0001,157,342,10,509,0,0
605304_667605_0587Acta0586.jpg,070602012.01.1.0001,184,203,8,395,0,0
605304_747325_0549Acta0548.jpg,070704008.01.1.0001,195,339,17,551,0,0
605304_800565_0539Acta0538.jpg,070704015.02.1.0001,49,345,4,398,0,0
605304_898651_0531Acta0530.jpg,070704006.03.1.0001,97,304,8,409,0,0
612833_174287_0128Acta0128.jpg,170101009.01.1.0001,163,74,10,247,0,0
612833_348327_0059Acta0059.jpg,170302003.02.1.0001,163,269,9,441,0,0
612833_359974_0279Acta0279.jpg,171301027.01.1.0001,221,285,3,509,0,0
612833_392085_0125Acta0125.jpg,170103005.01.1.0001,210,201,4,415,0,0
612833_415678_0215Acta0215.jpg,170302006.02.1.0001,240,324,18,582,0,0
612833_416525_0085Acta0085.jpg,170305001.01.1.0001,202,292,5,499,0,0
612833_520971_0062Acta0062.jpg,170302004.02.1.0001,229,388,13,630,0,0
612833_565393_0167Acta0167.jpg,170302016.01.1.0001,61,251,9,321,0,0
612833_584081_0146Acta0146.jpg,170104002.02.1.0001,262,315,11,588,0,0
612833_677371_0216Acta0216.jpg,170302006.01.1.0001,239,285,12,536,0,0
612833_731028_0118Acta0118.jpg,170101003.03.1.0001,241,217,5,463,0,0
612833_852807_0177Acta0177.jpg,170202001.01.1.0001,265,274,10,549,1,0
612833_890353_0261Acta0261.jpg,170304003.02.1.0001,124,376,10,510,0,0
612833_957474_0230Acta0230.jpg,170301015.01.1.0001,358,154,7,519,0,0
616478_607493_0081Acta0081.jpg,080601079.01.1.0001,142,163,7,312,0,0
616478_819985_0146Acta0146.jpg,080901014.01.1.0001,129,233,4,366,0,0
616478_913859_0200Acta0200.jpg,080601006.02.1.0001,98,311,12,421,0,0
616478_943389_0069Acta0069.jpg,080601046.01.1.0001,184,289,23,496,0,0
618687_185892_0480Acta0287.jpg,171004002.01.1.0001,220,124,6,350,0,0
618687_270745_0473Acta0283.jpg,171001012.01.1.0001,159,146,6,311,0,0
618687_550105_0438Acta0261.jpg,171003008.01.1.0001,133,34,6,173,0,0
618687_558871_0360Acta0207.jpg,170501001.01.1.0001,222,197,6,425,0,0
621754_552213_0074Acta0042.jpg,030502006.01.1.0001,12,50,2,64,0,0
626961_161343_0116Acta0116.jpg,170803003.01.1.0001,200,174,6,380,0,0
626961_357630_0161Acta0161.jpg,170801026.02.1.0001,280,155,10,445,0,0
626961_617504_0189Acta0189.jpg,171503001.02.1.0001,378,262,9,649,0,0
626961_771269_0121Acta0121.jpg,170801020.01.1.0001,181,103,7,291,0,0
629773_666621_0089Acta0089.jpg,240105004.02.1.0001,186,461,27,674,0,0
636635_314706_0036Acta0036.jpg,230101002.01.1.0001,83,307,5,395,1,0
636635_521730_0187Acta0187.jpg,230103002.01.1.0001,230,372,15,617,0,0
636635_566033_0037Acta0037.jpg,230101002.02.1.0001,123,300,1,424,0,0
636635_923828_0219Acta0219.jpg,230401004.01.1.0001,91,116,1,208,0,0
637933_004940_0483Acta0127.jpg,010111022.02.1.0001,227,238,19,484,0,0
637933_024079_0532Acta0176.jpg,010104046.04.1.0001,172,312,17,501,0,0
637933_042763_0600Acta0244.jpg,010110022.07.1.0001,178,292,22,492,1,0
637933_071806_0608Acta0252.jpg,010110150.02.1.0001,122,232,15,369,0,0
637933_276429_0567Acta0211.jpg,010104012.04.1.0001,116,413,23,552,0,0
637933_319940_0485Acta0129.jpg,010111022.01.1.0001,221,231,24,476,0,0
637933_324885_0560Acta0204.jpg,010104001.02.1.0001,89,295,11,395,0,0
637933_363286_0502Acta0146.jpg,010104003.01.1.0001,118,288,17,423,0,0
637933_490928_0510Acta0154.jpg,010104060.01.1.0001,151,162,4,317,0,0
637933_519700_0526Acta0170.jpg,010104022.04.1.0001,137,333,16,486,0,0
637933_610718_0491Acta0135.jpg,010111013.06.1.0001,217,352,20,589,0,0
637933_739778_0534Acta0178.jpg,010104014.01.1.0001,137,313,27,477,0,0
637933_798579_0500Acta0144.jpg,010104053.01.1.0001,123,235,16,374,0,0
637933_860196_0509Acta0153.jpg,010104036.01.1.0001,149,346,23,518,0,0
637933_901320_0591Acta0235.jpg,010110025.02.1.0001,170,323,18,511,0,0
637933_932356_0569Acta0213.jpg,010104012.03.1.0001,118,362,24,504,0,0
639559_020989_0259Acta0259.jpg,041101012.01.1.0001,197,227,13,437,0,0
639559_067570_0171Acta0171.jpg,040304006.01.1.0001,114,319,18,451,0,0
639559_123810_0170Acta0170.jpg,040301019.02.1.0001,216,289,17,522,0,0
639559_140301_0275Acta0275.jpg,041601008.01.1.0001,236,251,23,510,1,0
639559_178009_0332Acta0332.jpg,041201007.02.1.0001,209,268,18,495,0,0
639559_233771_0203Acta0203.jpg,040301012.01.1.0001,186,348,18,552,0,0
639559_339546_0242Acta0242.jpg,041101008.02.1.0001,140,289,22,451,0,0
639559_479570_0166Acta0166.jpg,040301010.02.1.0001,180,315,22,517,1,0
639559_542350_0125Acta0125.jpg,040304001.05.1.0001,114,418,8,540,0,0
639559_586152_0318Acta0318.jpg,041201003.02.1.0001,179,290,12,481,0,0
639559_625494_0323Acta0323.jpg,041201013.01.1.0001,173,110,13,296,0,0
639559_675050_0096Acta0096.jpg,040301010.03.1.0001,156,341,15,512,0,0
639559_735246_0214Acta0214.jpg,040301007.03.1.0001,119,312,13,444,1,0
639559_770744_0253Acta0253.jpg,041101007.01.1.0001,126,316,11,453,0,0
639559_868044_0237Acta0237.jpg,041101006.03.1.0001,148,309,12,469,0,0
639559_946161_0304Acta0304.jpg,041601015.03.1.0001,181,310,14,505,0,0
639559_963374_0294Acta0294.jpg,041601025.01.1.0001,261,256,31,548,0,0
653421_033814_2024-07-28-0001.jpg,071301010.01.1.0001,33,430,7,470,0,0
653421_224766_2024-07-29-0013.jpg,071101062.02.1.0001,158,215,15,388,1,0
653421_256892_2024-07-29-0001.jpg,071101023.01.1.0001,82,378,16,476,0,0
653421_443277_2024-07-28-0009.jpg,071301010.09.1.0001,43,440,12,495,0,0
653421_551994_2024-07-29-0008.jpg,070904017.01.1.0001,93,239,10,342,0,0
653421_662662_2024-07-29-0001.jpg,071301017.01.1.0001,111,444,14,569,0,0
653421_960295_2024-07-28-0011.jpg,071301010.11.1.0001,46,429,8,483,0,0
653905_417331_2024-07-29-0001.jpg,070203017.01.1.0001,163,309,19,491,0,0
653905_529564_2024-07-29-0003.jpg,070201001.02.1.0001,247,383,14,644,0,0
653905_540376_2024-07-29-0002.jpg,070203005.01.1.0001,129,294,11,434,0,0
653905_582845_2024-07-29-0001.jpg,070201005.01.1.0001,158,393,20,571,0,0
653905_669741_2024-07-29-0003.jpg,070203004.01.1.0001,140,363,25,528,1,0
653905_681309_2024-07-29-0001.jpg,070203030.01.1.0001,191,233,22,446,0,0
656297_057439_0625Acta0491.jpg,131801011.01.1.0001,54,289,9,352,0,0
656297_080371_0243Acta0109.jpg,131801017.02.1.0001,69,423,18,510,0,0
656297_098917_0292Acta0158.jpg,131801022.02.1.0001,60,308,7,375,0,0
656297_143116_0878Acta0660.jpg,130901044.04.1.0001,22,373,4,399,0,0
656297_155782_0263Acta0129.jpg,131901007.05.1.0001,34,351,8,393,0,0
656297_206281_0850Acta0647.jpg,130901012.04.1.0001,153,228,14,395,0,0
656297_382234_0784Acta0616.jpg,130901113.04.1.0001,67,315,5,387,0,0
656297_407690_0239Acta0105.jpg,131801004.04.1.0001,25,282,2,309,0,0
656297_419509_0472Acta0338.jpg,131801010.03.1.0001,68,371,13,452,0,0
656297_455236_0676Acta0542.jpg,130901067.05.1.0001,184,385,29,598,0,0
656297_457118_0653Acta0519.jpg,130901078.05.1.0001,114,392,19,525,0,0
656297_465854_0763Acta0605.jpg,130905001.04.1.0001,214,354,11,579,0,0
656297_473196_0446Acta0312.jpg,131901012.02.1.0001,81,369,13,463,0,0
656297_489051_0865Acta0654.jpg,130901015.02.1.0001,155,268,20,443,0,0
656297_493894_0312Acta0178.jpg,131801016.03.1.0001,26,369,4,399,0,0
656297_522918_0359Acta0225.jpg,131601020.02.1.0001,33,371,6,410,0,0
656297_572068_0727Acta0582.jpg,131601002.07.1.0001,34,309,6,349,0,0
656297_572106_0931Acta0686.jpg,130901017.01.1.0001,150,277,21,448,0,0
656297_611856_0489Acta0355.jpg,131601028.03.1.0001,124,284,15,423,0,0
656297_614511_0455Acta0321.jpg,131801002.01.1.0001,63,311,10,384,0,0
656297_620436_0551Acta0417.jpg,131601037.02.1.0001,86,413,17,516,0,0
656297_632108_0654Acta0520.jpg,130901078.01.1.0001,128,382,19,529,0,0
656297_635962_0519Acta0385.jpg,131602014.02.1.0001,30,325,1,356,0,0
656297_661943_0593Acta0459.jpg,131603009.05.1.0001,67,376,14,457,0,0
656297_678964_0754Acta0599.jpg,130901059.04.1.0001,88,393,13,494,0,0
656297_683344_0392Acta0258.jpg,131601021.02.1.0001,31,323,5,359,0,0
656297_690904_0720Acta0578.jpg,131601014.04.1.0001,14,341,0,355,0,0
656297_702985_0825Acta0634.jpg,130901074.02.1.0001,143,364,16,523,0,0
656297_707586_0299Acta0165.jpg,131801009.03.1.0001,35,366,10,411,0,0
656297_823526_0839Acta0641.jpg,130901030.03.1.0001,33,307,5,345,1,0
656297_830249_0305Acta0171.jpg,131801014.03.1.0001,32,344,5,381,0,0
656297_909890_0858Acta0651.jpg,130901099.01.1.0001,170,376,12,558,0,0
656297_935379_0338Acta0204.jpg,131601054.02.1.0001,25,390,2,417,0,0
656297_943374_0418Acta0284.jpg,131901003.03.1.0001,28,374,6,408,0,0
656297_946095_0761Acta0604.jpg,130905001.02.1.0001,226,329,21,576,0,0
656297_949807_0237Acta0103.jpg,131801004.05.1.0001,30,335,12,377,0,0
662379_072668_0159Acta0159.jpg,090403008.02.1.0001,137,358,11,506,0,0
662379_339187_0152Acta0152.jpg,090403014.04.1.0001,85,466,15,566,0,0
662379_376983_0245Acta0245.jpg,091602001.03.1.0001,54,359,4,417,0,0
662379_379157_0203Acta0203.jpg,090401001.01.1.0001,70,209,6,285,0,0
662379_477707_0219Acta0219.jpg,091601007.01.1.0001,70,213,5,288,0,0
662379_573071_0216Acta0216.jpg,090401003.03.1.0001,155,413,17,585,0,0
662379_615089_0113Acta0113.jpg,090401024.01.1.0001,120,327,10,457,0,0
662379_685119_0084Acta0084.jpg,090402008.03.1.0001,120,290,12,422,0,0
662379_726065_0060Acta0060.jpg,090402010.03.1.0001,130,411,10,551,0,0
662379_811195_0054Acta0054.jpg,090402006.02.1.0001,59,356,7,422,0,0
662379_851472_0114Acta0114.jpg,090401007.01.1.0001,123,427,11,561,0,0
662379_892342_0305Acta0305.jpg,090402017.01.1.0001,97,365,18,480,1,0
662379_923718_0192Acta0192.jpg,090401013.04.1.0001,122,317,10,449,0,0
662379_961016_0163Acta0163.jpg,090403018.02.1.0001,83,263,10,356,0,0
662379_963828_0166Acta0166.jpg,090403021.03.1.0001,119,345,8,472,0,0
667154_324247_0097Acta0081.jpg,100701003.02.1.0001,149,436,17,602,0,0
667154_798562_0065Acta0053.jpg,100501009.02.1.0001,254,375,11,640,0,0
667154_900843_0144Acta0106.jpg,100701060.01.1.0001,86,112,2,200,1,0
667448_054669_0313Acta0313.jpg,211805023.01.1.0001,103,257,9,369,0,0
667448_081069_0260Acta0260.jpg,211801004.02.1.0001,128,321,4,453,0,0
667448_109008_0168Acta0168.jpg,211802003.02.1.0001,91,305,0,396,0,0
667448_229175_0194Acta0194.jpg,211803014.01.1.0001,105,298,11,414,0,0
667448_231496_0157Acta0157.jpg,211803027.01.1.0001,124,314,8,446,0,0
667448_274759_0111Acta0111.jpg,211803033.03.1.0001,79,370,5,454,0,0
667448_325492_0304Acta0304.jpg,211805021.06.1.0001,106,366,10,482,0,0
667448_361207_0101Acta0101.jpg,211803018.02.1.0001,68,304,2,374,0,0
667448_372455_0292Acta0292.jpg,211805022.02.1.0001,121,269,7,397,0,0
667448_391119_0156Acta0156.jpg,211803027.03.1.0001,123,351,5,479,0,0
667448_404390_0328Acta0328.jpg,211802026.03.1.0001,87,392,3,482,0,0
667448_456043_0152Acta0152.jpg,211803020.02.1.0001,68,308,1,377,0,0
667448_492411_0100Acta0100.jpg,211803018.01.1.0001,55,302,5,362,0,0
667448_591102_0257Acta0257.jpg,211801002.04.1.0001,94,275,6,375,0,0
667448_699664_0143Acta0143.jpg,211803021.01.1.0001,80,329,8,417,0,0
667448_889504_0150Acta0150.jpg,211803020.03.1.0001,64,275,5,344,0,0
667448_918989_0218Acta0218.jpg,211807008.02.1.0001,165,223,6,394,0,0
667448_938978_0130Acta0130.jpg,211803006.02.1.0001,21,317,4,342,0,0
669215_008268_2024-07-28-0002.jpg,120407003.02.1.0001,94,307,12,413,0,0
669215_238478_2024-07-28-0003.jpg,120801001.03.1.0001,56,391,4,451,0,0
669215_252082_2024-07-29-0004.jpg,120901001.04.1.0001,107,501,11,619,0,0
669215_280862_2024-07-29-0002.jpg,120405002.02.1.0001,64,276,8,348,1,0
669215_283589_2024-07-28-0001.jpg,120812002.01.1.0001,65,415,6,486,0,0
669215_607925_2024-07-28-0001.jpg,120801002.01.1.0001,69,330,3,402,0,0
669215_642273_2024-07-29-0004.jpg,120406005.02.1.0001,48,568,14,630,0,0
669215_651078_2024-07-29-0005.jpg,120809002.05.1.0001,126,437,10,573,0,0
669215_779762_2024-07-29-0002.jpg,120813005.02.1.0001,71,386,7,464,0,0
669215_935113_2024-07-29-0002.jpg,120809002.02.1.0001,113,479,15,607,0,0
669283_344883_0033Acta0033.jpg,030403010.02.1.0001,246,315,8,569,0,0
670988_144923_0154Acta0113.jpg,131101032.02.1.0001,105,369,13,487,1,0
670988_204631_0241Acta0199.jpg,131101017.06.1.0001,57,488,9,554,0,0
670988_247161_0211Acta0169.jpg,131101024.03.1.0001,138,399,20,557,0,0
670988_371562_0147Acta0106.jpg,131101044.01.1.0001,231,227,30,488,0,0
670988_372618_0231Acta0189.jpg,131101016.04.1.0001,79,423,9,511,0,0
670988_384315_0237Acta0195.jpg,131101017.02.1.0001,69,397,4,470,0,0
670988_422067_0196Acta0155.jpg,131101010.05.1.0001,177,391,22,590,1,0
670988_444004_0107Acta0066.jpg,131102015.02.1.0001,258,181,34,473,0,0
670988_469394_0134Acta0093.jpg,131101043.01.1.0001,175,189,14,378,0,0
670988_490955_0282Acta0240.jpg,130801006.11.1.0001,65,396,9,470,0,0
670988_526545_0204Acta0163.jpg,131101033.02.1.0001,107,378,13,498,0,0
670988_573210_0229Acta0187.jpg,131101016.03.1.0001,66,427,11,504,0,0
670988_608083_0164Acta0123.jpg,131101031.06.1.0001,72,353,7,432,0,0
670988_630931_0239Acta0197.jpg,131101017.04.1.0001,65,440,11,516,0,0
670988_658597_0255Acta0213.jpg,131101069.01.1.0001,250,188,21,459,0,0
670988_712435_0280Acta0238.jpg,131101040.01.1.0001,177,340,12,529,0,0
670988_781750_0276Acta0234.jpg,131102001.04.1.0001,117,380,15,512,0,0
670988_835020_0151Acta0110.jpg,131101032.05.1.0001,79,364,13,456,0,0
670988_925031_0144Acta0103.jpg,131101035.02.1.0001,172,413,23,608,0,0
673056_070659_0638Acta0355.jpg,170901046.01.1.0001,221,317,16,554,0,0
673056_071807_0526Acta0243.jpg,170903011.02.1.0001,260,237,15,512,0,0
673056_089279_0687Acta0404.jpg,170903022.01.1.0001,140,464,15,619,0,0
673056_195922_0545Acta0262.jpg,170902012.03.1.0001,187,252,6,445,0,0
673056_237926_0503Acta0220.jpg,170903006.04.1.0001,207,302,18,527,0,0
673056_240623_0654Acta0371.jpg,170901075.02.1.0001,193,176,9,378,0,0
673056_254896_0415Acta0136.jpg,170901012.03.1.0001,196,407,22,625,0,0
673056_279778_0395Acta0116.jpg,170901014.01.1.0001,171,323,17,511,0,0
673056_297720_0598Acta0315.jpg,170904011.03.1.0001,108,409,11,528,0,0
673056_320236_0433Acta0154.jpg,170901020.02.1.0001,140,322,16,478,0,0
673056_338807_0476Acta0193.jpg,170901051.05.1.0001,129,372,20,521,0,0
673056_347371_0467Acta0184.jpg,170901011.03.1.0001,229,292,18,539,0,0
673056_365718_0631Acta0348.jpg,170901009.03.1.0001,203,307,11,521,0,0
673056_435324_0409Acta0130.jpg,170901032.04.1.0001,179,322,10,511,0,0
673056_441075_0419Acta0140.jpg,170901081.02.1.0001,205,184,15,404,0,0
673056_454265_0521Acta0238.jpg,170903016.01.1.0001,247,240,8,495,0,0
673056_533005_0485Acta0202.jpg,170903020.01.1.0001,236,333,24,593,0,0
673056_545049_0601Acta0318.jpg,170904010.02.1.0001,207,292,8,507,0,0
673056_582740_0589Acta0306.jpg,170904007.04.1.0001,108,336,6,450,0,0
673056_608679_0371Acta0092.jpg,170904020.01.1.0001,185,395,12,592,0,0
673056_686485_0459Acta0176.jpg,170901025.04.1.0001,206,408,20,634,0,0
673056_727249_0695Acta0412.jpg,170903014.02.1.0001,162,368,19,549,0,0
673056_785192_0711Acta0428.jpg,170907005.01.1.0001,178,89,17,284,0,0
673056_840975_0518Acta0235.jpg,170903008.01.1.0001,198,368,13,579,0,0
676442_071696_0278Acta0278.jpg,210102001.02.1.0001,86,355,3,444,0,0
676442_124595_0070Acta0070.jpg,211102020.04.1.0001,66,361,4,431,0,0
676442_249976_0320Acta0319.jpg,210105005.01.1.0001,199,219,8,426,0,0
676442_292163_0094Acta0094.jpg,211103006.03.1.0001,54,273,3,330,0,0
676442_296862_0115Acta0115.jpg,211106001.01.1.0001,107,341,11,459,0,0
676442_359149_0052Acta0052.jpg,211102015.01.1.0001,84,397,6,487,0,0
676442_380594_0168Acta0168.jpg,211105002.02.1.0001,50,278,4,332,0,0
676442_566439_0331Acta0330.jpg,210101008.01.1.0001,209,374,4,587,0,0
676442_779152_0221Acta0221.jpg,211502004.04.1.0001,66,282,1,349,0,0
676442_823985_0210Acta0210.jpg,211502014.01.1.0001,74,244,3,321,0,0
676442_833099_0209Acta0209.jpg,211503005.02.1.0001,118,271,12,401,0,0
676442_858640_0156Acta0156.jpg,211104002.01.1.0001,77,267,8,352,0,0
676442_903249_0280Acta0280.jpg,210106015.01.1.0001,104,386,7,497,0,0
676839_066486_0623Acta0546.jpg,211803023.02.1.0001,77,281,5,363,0,0
676839_139523_0482Acta0482.jpg,210509036.02.1.0001,236,328,18,582,0,0
676839_289108_0308Acta0308.jpg,210511007.02.1.0001,71,337,2,410,0,0
676839_348482_0057Acta0057.jpg,210503025.01.1.0001,103,325,12,440,0,0
676839_372466_0418Acta0418.jpg,210505012.02.1.0001,35,308,8,351,0,0
676839_416480_0067Acta0067.jpg,210502007.03.1.0001,33,316,3,352,0,0
676839_470195_0383Acta0383.jpg,210508010.05.1.0001,52,314,5,371,0,0
676839_471258_0459Acta0459.jpg,210501003.01.1.0001,52,338,7,397,0,0
676839_514498_0095Acta0095.jpg,210502011.03.1.0001,79,314,3,396,0,0
676839_528788_0237Acta0237.jpg,210514007.03.1.0001,80,320,4,404,0,0
676839_533167_0241Acta0241.jpg,210514007.07.1.0001,94,368,6,468,0,0
676839_539727_0424Acta0424.jpg,210505001.03.1.0001,38,223,0,261,0,0
676839_550848_0182Acta0182.jpg,210504006.01.1.0001,77,425,4,506,0,0
676839_564739_0208Acta0208.jpg,210504020.04.1.0001,54,273,2,329,0,0
676839_572586_0390Acta0390.jpg,210509041.01.1.0001,199,190,13,402,0,0
676839_655091_0413Acta0413.jpg,210505005.02.1.0001,94,324,8,426,0,0
676839_701227_0055Acta0055.jpg,210503025.03.1.0001,74,339,6,419,0,0
676839_766099_0043Acta0043.jpg,210503007.02.1.0001,60,402,6,468,0,0
676839_778134_0222Acta0222.jpg,210507008.02.1.0001,52,312,4,368,0,0
676839_823541_0046Acta0046.jpg,210517004.02.1.0001,121,280,6,407,0,0
676839_843928_0079Acta0079.jpg,210502010.04.1.0001,70,343,6,419,0,0
676839_848558_0649Acta0555.jpg,210506004.03.1.0001,38,297,4,339,0,0
676839_849377_0059Acta0059.jpg,210503001.02.1.0001,78,277,8,363,0,0
676839_853088_0112Acta0112.jpg,210502014.01.1.0001,132,376,6,514,0,0
676839_871912_0098Acta0098.jpg,210502009.03.1.0001,43,258,6,307,0,0
676839_903468_0274Acta0274.jpg,210511011.04.1.0001,94,290,6,390,0,0
676839_915703_0382Acta0382.jpg,210508010.06.1.0001,37,305,2,344,0,0
676839_945444_0035Acta0035.jpg,210503019.01.1.0001,81,384,7,472,0,0
676839_954004_0106Acta0106.jpg,210502008.05.1.0001,23,311,0,334,0,0
676839_967609_0564Acta0515.jpg,211805044.01.1.0001,98,238,7,343,0,0
677437_132871_0065Acta0065.jpg,190503006.02.1.0001,135,353,14,502,0,0
677437_220225_0346Acta0345.jpg,190305004.01.1.0001,113,161,6,280,0,0
677437_328415_0127Acta0127.jpg,192001002.02.1.0001,214,356,4,574,0,0
677437_400247_0268Acta0267.jpg,190301003.01.1.0001,137,402,10,549,0,0
677437_668075_0074Acta0074.jpg,190507003.01.1.0001,216,240,12,468,0,0
677437_738085_0331Acta0330.jpg,190802004.01.1.0001,109,91,2,202,0,0
677437_769325_0177Acta0177.jpg,191701001.01.1.0001,167,409,5,581,0,0
677437_822191_0124Acta0124.jpg,192001003.03.1.0001,101,374,10,485,0,0
677437_853606_0041Acta0041.jpg,190501001.03.1.0001,130,301,4,435,0,0
677437_896971_0063Acta0063.jpg,190503001.02.1.0001,151,475,3,629,0,0
684534_118886_0047Acta0047.jpg,022101004.01.1.0001,210,182,13,405,0,0
684534_149588_0085Acta0085.jpg,020401005.01.1.0001,259,314,22,595,0,0
684534_395101_0029Acta0029.jpg,021101008.01.1.0001,121,293,3,417,0,0
684534_537002_0131Acta0131.jpg,021601001.03.1.0001,140,375,7,522,0,0
684534_675670_0050Acta0050.jpg,022101002.02.1.0001,243,293,19,555,0,0
684534_759263_0107Acta0107.jpg,021601009.02.1.0001,277,310,19,606,0,0
684967_213928_0179Acta0178.jpg,210801001.02.1.0001,71,308,9,388,0,0
684967_259428_0092Acta0091.jpg,210803015.03.1.0001,87,381,2,470,0,0
684967_495662_0140Acta0139.jpg,210803012.03.1.0001,67,342,6,415,0,0
684967_809079_0176Acta0175.jpg,210801001.05.1.0001,63,346,10,419,0,0
684967_843690_0144Acta0143.jpg,210803001.01.1.0001,76,390,5,471,0,0
691452_183023_0148Acta0064.jpg,122003001.01.1.0001,165,309,7,481,0,0
691452_216857_0133Acta0056.jpg,120601005.01.1.0001,116,318,4,438,0,0
691452_609427_0240Acta0119.jpg,210904006.03.1.0001,71,287,3,361,0,0
691452_668989_0180Acta0082.jpg,121301001.03.1.0001,85,494,8,587,0,0
691452_981626_0153Acta0066.jpg,122002001.02.1.0001,231,304,13,548,0,0
697380_048775_0155Acta0155.jpg,181902007.01.1.0001,45,83,4,132,0,0
697380_648114_0147Acta0147.jpg,181901009.01.1.0001,71,409,12,492,0,0
697380_998941_0176Acta0176.jpg,122101001.02.1.0001,85,273,9,367,0,0
703576_001533_0051Acta0049.jpg,040601024.03.1.0001,87,382,13,482,0,0
703576_310323_0113Acta0111.jpg,040601018.03.1.0001,176,323,16,515,0,0
703576_320820_0054Acta0052.jpg,040601011.01.1.0001,224,367,18,609,0,0
703576_353239_0086Acta0084.jpg,040601004.02.1.0001,176,395,18,589,0,0
703576_385347_0119Acta0117.jpg,040601021.03.1.0001,112,345,12,469,0,0
703576_568759_0066Acta0064.jpg,040601008.04.1.0001,199,367,11,577,0,0
703576_652913_0116Acta0114.jpg,040601019.03.1.0001,71,327,8,406,0,0
703576_941910_0060Acta0058.jpg,040601012.03.1.0001,150,351,19,520,0,0
706419_278714_0101Acta0101.jpg,040801020.02.1.0001,185,356,19,560,0,0
706419_511253_0144Acta0144.jpg,040801014.03.1.0001,226,350,26,602,0,0
706419_545141_0121Acta0121.jpg,040801024.01.1.0001,194,364,17,575,0,0
706419_669259_0156Acta0156.jpg,040803002.04.1.0001,165,412,18,595,0,0
709047_142009_0213Acta0089.jpg,121101002.02.1.0001,68,413,4,485,0,0
709047_153446_0245Acta0113.jpg,122302004.01.1.0001,71,203,2,276,0,0
709047_203638_0246Acta0114.jpg,122301001.01.1.0001,70,434,8,512,0,0
709047_289499_0192Acta0079.jpg,121701007.01.1.0001,22,583,10,615,0,0
709624_106695_0261Acta0174.jpg,180401003.03.1.0001,46,416,7,469,0,0
709624_108666_0401Acta0280.jpg,180401009.01.1.0001,65,443,17,525,0,0
709624_152194_0151Acta0064.jpg,180401004.03.1.0001,38,437,4,479,0,0
709624_186323_0550Acta0361.jpg,181201015.01.1.0001,62,464,7,533,0,0
709624_204079_0243Acta0156.jpg,180401016.01.1.0001,58,414,12,484,0,0
709624_343270_0275Acta0188.jpg,180403002.02.1.0001,61,387,5,453,0,0
709624_469010_0519Acta0350.jpg,181801001.02.1.0001,77,582,10,669,0,0
709624_524148_0544Acta0358.jpg,181201011.03.1.0001,85,520,11,616,0,0
709624_526270_0150Acta0063.jpg,180401004.02.1.0001,32,413,4,449,0,0
709624_608513_0413Acta0285.jpg,180401024.02.1.0001,100,437,8,545,0,0
709624_778874_0538Acta0357.jpg,181201016.01.1.0001,86,418,10,514,0,0
709624_787305_0548Acta0360.jpg,181201010.01.1.0001,42,342,5,389,0,0
709624_862632_0525Acta0353.jpg,181201001.02.1.0001,58,481,7,546,0,0
709624_937831_0553Acta0362.jpg,181201020.02.1.0001,81,489,7,577,0,0
709624_972894_0418Acta0287.jpg,180401014.02.1.0001,80,329,9,418,0,0
709624_992264_0517Acta0350.jpg,181801003.03.1.0001,52,430,6,488,0,0
720411_129869_0052Acta0052.jpg,190201010.01.1.0001,64,95,7,166,0,0
720411_146739_0088Acta0088.jpg,190202008.02.1.0001,293,261,17,571,0,0
720411_151549_0135Acta0135.jpg,190206005.01.1.0001,24,162,8,194,0,0
720411_262884_0104Acta0104.jpg,190202005.02.1.0001,143,410,14,567,0,0
720411_529848_0155Acta0155.jpg,190201028.01.1.0001,81,105,4,190,0,0
720411_712229_0154Acta0154.jpg,190201002.02.1.0001,85,417,12,514,0,0
720411_795405_0200Acta0200.jpg,191802005.01.1.0001,144,139,7,290,0,0
720411_829522_0157Acta0157.jpg,190202002.02.1.0001,154,391,12,557,1,0
720411_978095_0084Acta0084.jpg,190202009.01.1.0001,72,59,5,136,0,0
720660_013434_0068Acta0067.jpg,110207065.03.1.0001,138,368,26,532,0,0
720660_055601_0179Acta0178.jpg,110207023.02.1.0001,170,417,21,608,0,0
720660_058667_0053Acta0052.jpg,110207072.02.1.0001,134,323,13,470,1,0
720660_243879_0050Acta0049.jpg,110207008.03.1.0001,91,383,15,489,0,0
720660_335334_0208Acta0206.jpg,110207055.01.1.0001,184,413,25,622,0,0
720660_570484_0168Acta0167.jpg,110207016.01.1.0001,146,378,12,536,0,0
720660_637248_0098Acta0097.jpg,110207032.01.1.0001,110,476,9,595,0,0
720660_640952_0013Acta0012.jpg,110207029.01.1.0001,127,357,17,501,0,0
720660_874421_0198Acta0197.jpg,110207145.02.1.0001,105,340,14,459,0,0
720660_934364_0169Acta0168.jpg,110207016.02.1.0001,167,339,18,524,0,0
720660_946042_0173Acta0172.jpg,110207016.06.1.0001,143,371,9,523,0,0
725392_858806_0087Acta0087.jpg,100401003.02.1.0001,155,441,14,610,0,0
727113_248683_0047Acta0047.jpg,211403020.01.1.0001,251,158,9,418,0,0
727113_708123_0191Acta0191.jpg,211401011.02.1.0001,84,313,7,404,0,0
727113_856387_0212Acta0212.jpg,211406009.01.1.0001,99,235,6,340,0,0
727113_911636_0169Acta0169.jpg,211401001.03.1.0001,88,301,8,397,0,0
727585_090628_0173Acta0173.jpg,050209008.01.1.0001,129,301,14,444,0,0
727585_127756_0044Acta0044.jpg,050211005.04.1.0001,75,489,5,569,0,0
727585_140168_0408Acta0408.jpg,050211002.01.1.0001,56,247,13,316,0,0
727585_163948_0109Acta0109.jpg,050208007.03.1.0001,66,412,6,484,0,0
727585_238154_0235Acta0235.jpg,050210002.03.1.0001,72,439,9,520,0,0
727585_249007_0776Acta0776.jpg,050601037.01.1.0001,98,474,8,580,0,0
727585_297367_0640Acta0640.jpg,050902025.01.1.0001,77,136,6,219,0,0
727585_302644_0515Acta0515.jpg,050302006.02.1.0001,76,355,2,433,0,0
727585_355257_0374Acta0374.jpg,050211012.02.1.0001,91,475,8,574,0,0
727585_359796_0727Acta0727.jpg,050902001.03.1.0001,115,272,12,399,0,0
727585_390597_0533Acta0533.jpg,051101002.02.1.0001,93,320,4,417,0,0
727585_431703_0311Acta0311.jpg,050209001.04.1.0001,79,443,6,528,0,0
727585_500063_0075Acta0075.jpg,050209004.03.1.0001,114,405,12,531,0,0
727585_527870_0108Acta0108.jpg,050208007.04.1.0001,55,401,5,461,0,0
727585_539271_0761Acta0761.jpg,050209011.02.1.0001,100,299,12,411,0,0
727585_599936_0484Acta0484.jpg,050302005.02.1.0001,100,454,17,571,0,0
727585_609987_0196Acta0196.jpg,050207011.03.1.0001,69,456,7,532,0,0
727585_635332_0551Acta0551.jpg,051102003.01.1.0001,97,259,5,361,0,0
727585_674143_0721Acta0721.jpg,050208009.01.1.0001,117,420,6,543,0,0
727585_863307_0320Acta0320.jpg,050209023.01.1.0001,97,170,5,272,0,0
727585_875322_0142Acta0142.jpg,050202007.02.1.0001,110,413,10,533,0,0
727585_890760_0532Acta0532.jpg,051101010.02.1.0001,103,401,2,506,0,0
727585_898703_0178Acta0178.jpg,050207002.03.1.0001,73,469,6,548,0,0
727585_938063_0114Acta0114.jpg,050208002.02.1.0001,113,462,9,584,1,0
727585_942664_0733Acta0733.jpg,050902018.01.1.0001,133,312,4,449,0,0
727702_043933_0176Acta0072.jpg,131301027.04.1.0001,120,406,10,536,0,0
727702_054492_0152Acta0052.jpg,131301002.03.1.0001,96,437,19,552,1,0
727702_068846_0319Acta0144.jpg,131701021.03.1.0001,101,335,17,453,0,0
727702_152366_0140Acta0040.jpg,131301008.02.1.0001,57,382,16,455,0,0
727702_244474_0171Acta0068.jpg,131301018.04.1.0001,66,308,9,383,0,0
727702_372441_0249Acta0100.jpg,131701011.02.1.0001,84,371,19,474,1,0
727702_385991_0154Acta0054.jpg,131301014.02.1.0001,122,382,9,513,0,0
727702_497702_0153Acta0053.jpg,131301002.04.1.0001,89,452,8,549,0,0
727702_504827_0178Acta0073.jpg,131301027.06.1.0001,118,399,11,528,0,0
727702_541881_0230Acta0091.jpg,131701015.01.1.0001,141,473,23,637,0,0
727702_616689_0172Acta0069.jpg,131301027.02.1.0001,100,392,9,501,0,0
727702_636977_0242Acta0098.jpg,131701004.03.1.0001,106,416,17,539,0,0
727702_658384_0183Acta0074.jpg,131301015.05.1.0001,43,385,10,438,0,0
727702_801866_0311Acta0136.jpg,131701005.04.1.0001,71,433,13,517,0,0
727702_823886_0295Acta0122.jpg,131701009.05.1.0001,123,461,13,597,0,0
727702_928507_0141Acta0041.jpg,131301010.05.1.0001,70,351,14,435,0,0
727702_986107_0204Acta0082.jpg,131301007.03.1.0001,43,325,11,379,0,0
745895_004062_0052Acta0052.jpg,100101018.02.1.0001,105,292,7,404,0,0
745895_164937_0063Acta0063.jpg,100101004.01.1.0001,173,377,15,565,0,0
745895_416157_0141Acta0141.jpg,100101038.02.1.0001,174,424,16,614,0,0
745895_504313_0083Acta0083.jpg,100101005.04.1.0001,174,364,15,553,0,0
745895_526614_0047Acta0047.jpg,100101021.03.1.0001,61,421,9,491,0,0
745895_847562_0075Acta0075.jpg,100101013.01.1.0001,100,459,6,565,0,0
746782_311271_0079Acta0075.jpg,100601014.02.1.0001,140,286,8,434,0,0
746782_429017_0102Acta0098.jpg,100601025.02.1.0001,84,351,9,444,0,0
746782_523390_0073Acta0069.jpg,100601047.01.1.0001,280,370,16,666,0,0
746782_566440_0123Acta0119.jpg,100601022.01.1.0001,119,388,9,516,0,0
746782_799246_0038Acta0034.jpg,100601009.01.1.0001,211,358,14,583,0,0
751094_155799_0212Acta0212.jpg,020901007.01.1.0001,193,378,12,583,0,0
751094_176499_0265Acta0265.jpg,021201031.01.1.0001,62,233,13,308,0,0
751094_380657_0168Acta0168.jpg,021201018.02.1.0001,98,388,18,504,0,0
751094_450019_0292Acta0292.jpg,021003001.03.1.0001,135,254,15,404,0,0
751094_776596_0269Acta0269.jpg,021201025.01.1.0001,103,494,9,606,0,0
751094_886064_0122Acta0122.jpg,021201024.02.1.0001,110,350,14,474,0,0
751094_890668_0246Acta0246.jpg,021201021.05.1.0001,75,480,10,565,0,0
752341_166683_0223Acta0216.jpg,020301007.01.1.0001,122,463,13,598,0,0
752341_169263_0093Acta0086.jpg,020302022.03.1.0001,115,303,7,425,0,0
752341_273153_0154Acta0147.jpg,020302041.01.1.0001,175,365,28,568,0,0
752341_674872_0073Acta0066.jpg,020302020.02.1.0001,217,351,17,585,0,0
752341_697288_0131Acta0124.jpg,020302026.01.1.0001,161,413,17,591,0,0
752341_772601_0072Acta0065.jpg,020302020.01.1.0001,224,323,15,562,0,0
752341_852237_0031Acta0024.jpg,020302017.01.1.0001,95,326,17,438,0,0
752341_877569_0183Acta0176.jpg,020302060.05.1.0001,216,287,21,524,0,0
752341_971441_0076Acta0069.jpg,020302016.03.1.0001,152,357,20,529,0,0
753682_348717_0125Acta0071.jpg,150701002.01.1.0001,152,494,18,664,0,0
758385_019352_1123Acta0112.jpg,132101001.02.1.0001,239,235,11,485,0,0
758385_030063_1112Acta0103.jpg,132101002.01.1.0001,368,258,12,638,0,0
758385_238410_0996Acta0026.jpg,130201006.02.1.0001,162,281,27,470,0,0
758385_694149_1044Acta0071.jpg,132001012.01.1.0001,217,260,17,494,0,0
768831_020977_0109Acta0085.jpg,110201003.03.1.0001,42,370,6,418,0,0
768831_076584_0170Acta0137.jpg,110202026.04.1.0001,50,461,2,513,0,0
768831_083307_0198Acta0165.jpg,110201036.02.1.0001,178,490,12,680,0,0
768831_134247_0141Acta0117.jpg,110202022.03.1.0001,94,484,14,592,0,0
768831_347497_0135Acta0111.jpg,110201050.02.1.0001,85,362,17,464,0,0
768831_571450_0029Acta0014.jpg,110201037.02.1.0001,142,398,10,550,0,0
770496_042572_0231Acta0231.jpg,110611001.03.1.0001,188,411,9,608,0,0
770496_050898_0033Acta0033.jpg,110601004.02.1.0001,117,390,14,521,0,0
770496_297123_0230Acta0230.jpg,110611001.02.1.0001,149,395,10,554,0,0
770496_319834_0088Acta0088.jpg,110601035.01.1.0001,143,209,15,367,0,0
770496_611466_0101Acta0101.jpg,110601054.01.1.0001,167,485,11,663,0,0
770496_651508_0165Acta0165.jpg,110616005.01.1.0001,329,157,9,495,0,0
770496_710154_0071Acta0071.jpg,110606002.01.1.0001,89,262,7,358,0,0
770496_717087_0177Acta0177.jpg,110601019.02.1.0001,141,387,12,540,0,0
771068_050111_0102Acta0100.jpg,040902016.01.1.0001,134,212,18,364,0,0
771068_078821_0173Acta0171.jpg,041001014.01.1.0001,124,323,20,467,0,0
771068_135874_0132Acta0130.jpg,040901001.03.1.0001,134,420,33,587,0,0
771068_156711_0104Acta0102.jpg,040901013.02.1.0001,149,243,18,410,0,0
771068_300208_0142Acta0140.jpg,040902020.01.1.0001,137,302,23,462,0,0
771068_325800_0076Acta0074.jpg,040902011.02.1.0001,84,321,14,419,0,0
771068_340950_0077Acta0075.jpg,040901003.02.1.0001,125,397,30,552,0,0
771068_479574_0165Acta0163.jpg,041001003.03.1.0001,102,353,17,472,0,0
771068_515780_0202Acta0200.jpg,041701005.03.1.0001,158,387,25,570,0,0
771068_523983_0280Acta0278.jpg,041702005.02.1.0001,146,318,10,474,0,0
771068_749190_0091Acta0089.jpg,040901004.01.1.0001,71,384,23,478,0,0
771068_760730_0083Acta0081.jpg,040902007.02.1.0001,157,437,20,614,0,0
771068_772414_0082Acta0080.jpg,040902007.01.1.0001,161,418,27,606,0,0
771068_832076_0312Acta0310.jpg,041703003.01.1.0001,149,305,17,471,0,0
771068_833907_0133Acta0131.jpg,040901001.04.1.0001,145,397,23,565,0,0
771068_903296_0327Acta0325.jpg,040901004.04.1.0001,90,344,18,452,0,0
771727_055608_0147Acta0147.jpg,160901002.02.1.0001,107,485,15,607,0,0
771727_288510_0071Acta0071.jpg,160702004.01.1.0001,267,144,2,413,0,0
771727_413659_0054Acta0054.jpg,160701016.01.1.0001,186,544,7,737,0,0
771727_432708_0128Acta0128.jpg,160902003.02.1.0001,205,209,9,423,0,0
771727_731599_0066Acta0066.jpg,160701007.01.1.0001,135,393,10,538,0,0
772156_571225_0151Acta0151.jpg,210305015.03.1.0001,169,285,6,460,0,0
772156_648614_0148Acta0148.jpg,210305005.06.1.0001,107,429,5,541,0,0
772448_007828_0054Acta0054.jpg,110206028.01.1.0001,172,163,8,343,0,0
772448_016346_0128Acta0128.jpg,110101002.03.1.0001,162,430,15,607,0,0
772448_436804_0091Acta0091.jpg,110102005.01.1.0001,229,369,20,618,0,0
772448_485139_0076Acta0076.jpg,110102009.01.1.0001,176,269,9,454,0,0
772448_488169_0078Acta0078.jpg,110102003.01.1.0001,113,267,9,389,0,0
772448_876191_0119Acta0119.jpg,110101018.01.1.0001,148,373,9,530,0,0
772448_945900_0098Acta0098.jpg,110101007.01.1.0001,113,237,11,361,0,0
772584_499234_0181Acta0170.jpg,210407001.02.1.0001,329,183,7,519,0,0
772584_546816_0149Acta0138.jpg,210402009.03.1.0001,198,274,12,484,0,0
772584_606052_0184Acta0173.jpg,210407006.02.1.0001,159,289,13,461,0,0
772584_721434_0073Acta0062.jpg,210404001.04.1.0001,210,346,11,567,0,0
784821_102873_0096Acta0095.jpg,240104036.01.1.0001,197,421,19,637,0,0
784821_390571_0159Acta0158.jpg,240110006.02.1.0001,133,374,16,523,0,0
784821_479911_0168Acta0167.jpg,240111011.02.1.0001,189,413,11,613,0,0
784821_493619_0067Acta0066.jpg,240104009.02.1.0001,195,363,12,570,0,0
784821_762834_0088Acta0087.jpg,240110005.01.1.0001,185,393,12,590,0,0
784821_850223_0052Acta0051.jpg,240104039.01.1.0001,135,198,5,338,0,0
786908_331706_0134Acta0134.jpg,191601002.01.1.0001,223,323,9,555,0,0
786908_626539_0050Acta0050.jpg,190903001.02.1.0001,266,341,11,618,0,0
788144_057628_0310Acta0176.jpg,181001015.02.1.0001,84,252,4,340,0,0
788144_066285_1029Acta0576.jpg,180803005.02.1.0001,61,421,8,490,0,0
788144_142322_0807Acta0467.jpg,180804002.01.1.0001,57,288,10,355,0,0
788144_153265_0417Acta0230.jpg,182801016.01.1.0001,85,87,3,175,0,0
788144_176349_0281Acta0160.jpg,181001012.01.1.0001,106,417,13,536,0,0
788144_275441_0464Acta0258.jpg,180803008.02.1.0001,72,372,5,449,0,0
788144_291441_0905Acta0519.jpg,180802008.05.1.0001,29,371,11,411,0,0
788144_314943_0883Acta0509.jpg,180802026.04.1.0001,57,479,5,541,0,0
788144_340213_0690Acta0388.jpg,180801008.02.1.0001,65,329,11,405,0,0
788144_350113_0971Acta0554.jpg,180801018.02.1.0001,73,347,12,432,0,0
788144_420618_0871Acta0505.jpg,180802014.01.1.0001,41,319,9,369,0,0
788144_422980_0779Acta0446.jpg,180301012.01.1.0001,29,289,5,323,0,0
788144_442522_0536Acta0301.jpg,182003007.01.1.0001,92,194,5,291,0,0
788144_449116_0579Acta0334.jpg,182001004.01.1.0001,84,460,14,558,0,0
788144_529118_0618Acta0356.jpg,180803012.04.1.0001,64,401,4,469,0,0
788144_583152_1010Acta0568.jpg,180801006.02.1.0001,66,387,6,459,0,0
788144_600653_0215Acta0127.jpg,180802021.02.1.0001,61,273,8,342,0,0
788144_620550_0611Acta0354.jpg,180803013.03.1.0001,47,429,2,478,0,0
788144_623715_0957Acta0551.jpg,180801020.01.1.0001,77,482,8,567,0,0
788144_643438_0239Acta0140.jpg,180803015.04.1.0001,64,452,3,519,0,0
788144_673442_0478Acta0264.jpg,180803014.03.1.0001,53,482,6,541,0,0
788144_794391_0846Acta0494.jpg,180802019.02.1.0001,50,290,11,351,0,0
788144_809344_0743Acta0421.jpg,180302009.01.1.0001,62,91,5,158,0,0
788144_857759_0486Acta0266.jpg,180803036.01.1.0001,27,406,3,436,0,0
788144_870531_0725Acta0409.jpg,180303001.02.1.0001,60,463,8,531,0,0
788144_877985_0823Acta0477.jpg,180804004.01.1.0001,59,303,4,366,0,0
788144_909662_0450Acta0251.jpg,180803026.01.1.0001,150,398,15,563,0,0
788144_930647_1039Acta0582.jpg,180803002.03.1.0001,98,369,8,475,1,0
788458_055217_0157Acta0093.jpg,021701005.03.1.0001,66,375,12,453,0,0
788458_075977_0225Acta0161.jpg,020301021.03.1.0001,176,384,17,577,0,0
788458_138804_0305Acta0241.jpg,020301012.06.1.0001,143,454,19,616,0,0
788458_442402_0142Acta0078.jpg,021701012.03.1.0001,48,308,7,363,0,0
788458_614855_0145Acta0081.jpg,021701002.04.1.0001,75,351,8,434,0,0
788458_649452_0184Acta0120.jpg,020301006.01.1.0001,89,428,9,526,0,0
788458_676387_0261Acta0197.jpg,020301026.05.1.0001,90,414,6,510,0,0
788458_777752_0177Acta0113.jpg,020301009.01.1.0001,88,408,3,499,1,0
788458_821091_0127Acta0063.jpg,021702001.01.1.0001,30,374,5,409,0,0
788458_828284_0190Acta0126.jpg,020301045.04.1.0001,103,401,9,513,1,0
788458_833618_0193Acta0129.jpg,020301019.03.1.0001,143,282,13,438,0,0
788458_941625_0252Acta0188.jpg,020301062.03.1.0001,87,422,6,515,0,0
788482_257675_0134Acta0134.jpg,110407017.01.1.0001,147,122,6,275,0,0
788482_669740_0062Acta0062.jpg,110401010.01.1.0001,119,521,11,651,0,0
788482_794973_0123Acta0123.jpg,110403001.03.1.0001,93,386,18,497,0,0
A01950_240429_0375Acta0200.jpg,020601010.03.1.0001,111,359,6,476,0,0
A01950_249089_0390Acta0215.jpg,020601002.03.1.0001,100,374,8,482,0,0
A01950_284084_0478Acta0303.jpg,022001001.02.1.0001,280,337,15,632,0,0
A01950_618634_0521Acta0346.jpg,020603004.01.1.0001,422,115,17,554,0,0
A01950_631012_0310Acta0135.jpg,020803001.02.1.0001,275,267,9,551,1,0
A01950_788104_0376Acta0201.jpg,020601010.02.1.0001,112,336,7,455,0,0
A01950_950797_0506Acta0331.jpg,020101006.02.1.0001,88,356,13,457,0,0
A09535_002087_1168Acta0550.jpg,060303010.03.1.0001,117,456,11,584,0,0
A09535_016377_0922Acta0304.jpg,060301004.03.1.0001,64,337,3,404,0,0
A09535_082665_0853Acta0235.jpg,060301025.02.1.0001,59,361,2,422,0,0
A09535_096772_0913Acta0295.jpg,060301031.01.1.0001,84,250,4,338,0,0
A09535_145812_0833Acta0215.jpg,060301029.01.1.0001,56,235,5,296,0,0
A09535_162543_0926Acta0308.jpg,060304019.01.1.0001,60,330,9,399,0,0
A09535_213788_1100Acta0482.jpg,060302011.04.1.0001,88,357,13,458,0,0
A09535_267626_1109Acta0491.jpg,060302010.02.1.0001,109,354,13,476,0,0
A09535_317698_1078Acta0460.jpg,060301001.01.1.0001,103,446,8,557,0,0
A09535_329505_0859Acta0241.jpg,060305009.03.1.0001,128,394,13,535,0,0
A09535_352069_0844Acta0226.jpg,060301027.03.1.0001,59,352,6,417,0,0
A09535_369737_0975Acta0357.jpg,060303054.01.1.0001,153,272,10,435,0,0
A09535_475724_1090Acta0472.jpg,060304013.04.1.0001,57,338,4,399,0,0
A09535_477429_1104Acta0486.jpg,060302015.01.1.0001,133,262,18,413,0,0
A09535_477909_1006Acta0388.jpg,060306003.03.1.0001,162,340,21,523,0,0
A09535_655644_0870Acta0252.jpg,060305003.02.1.0001,151,291,15,457,0,0
A09535_750621_1051Acta0433.jpg,060303050.01.1.0001,119,261,7,387,0,0
A09535_789393_1087Acta0469.jpg,060304003.01.1.0001,47,261,6,314,0,0
A09535_841829_1069Acta0451.jpg,060301005.02.1.0001,76,357,9,442,0,0
A09535_962668_0822Acta0204.jpg,060301020.01.1.0001,93,314,12,419,0,0
AG8A001761_192092_2024-07-29-0004.jpg,160101089.01.1.0001,285,187,12,484,1,0
AG8A001761_307289_2024-07-29-0002.jpg,160301074.01.1.0001,72,322,2,396,0,0
AG8A001761_310937_2024-07-28-0086.jpg,160301044.02.1.0001,118,382,10,510,0,0
AG8A001761_834693_2024-07-28-0094.jpg,160301030.04.1.0001,61,423,6,490,0,0
AG8A003757_188092_2024-07-29-0001.jpg,080201012.02.1.0001,71,378,10,459,0,0
AG8A003757_293845_2024-07-29-0001.jpg,080701031.01.1.0001,205,170,9,384,0,0
AG8A003757_383617_2024-07-28-0001.jpg,080801003.02.1.0001,142,340,8,490,0,0
AG8A003757_423378_2024-07-29-0001.jpg,080701030.01.1.0001,133,84,6,223,0,0
AG8A003757_483091_2024-07-29-0002.jpg,080201035.01.1.0001,162,269,10,441,0,0
AG8A003757_648333_2024-07-29-0001.jpg,080201021.03.1.0001,156,269,16,441,0,0
AG8A003757_855068_2024-07-29-0001.jpg,080201060.02.1.0001,95,296,5,396,0,0
AG8A003982_266327_2024-07-28-0004.jpg,120104003.01.1.0001,31,138,16,185,0,0
AG8A003982_380428_2024-07-29-0001.jpg,120107004.01.1.0001,42,412,3,457,0,0
AG8A003982_466167_2024-07-28-0003.jpg,120104002.02.1.0001,61,372,6,439,0,0
AG8A004112_911945_2024-07-29-0006.jpg,091802005.01.1.0001,192,371,15,578,0,0
AG8A004164_102350_2024-07-29-0001.jpg,191301002.02.1.0001,108,414,4,526,0,0
AG8A004164_119779_2024-07-29-0001.jpg,190603002.01.1.0001,173,482,17,672,1,0
AG8A004164_167235_2024-07-29-0001.jpg,190701002.01.1.0001,122,356,6,484,0,0
AG8A004164_220938_2024-07-29-0001.jpg,191303001.04.1.0001,128,374,6,508,1,0
AG8A004164_228756_2024-07-29-0001.jpg,190702006.04.1.0001,44,379,2,425,0,0
AG8A004164_421377_2024-07-29-0001.jpg,190606001.01.1.0001,113,387,5,505,0,0
AG8A004164_674566_2024-07-29-0001.jpg,190104001.01.1.0001,142,278,5,425,0,0
AG8A004164_881715_2024-07-29-0001.jpg,191303002.03.1.0001,137,382,11,530,0,0
AG8A004164_906320_2024-07-28-0001.jpg,190702004.03.1.0001,119,351,6,476,0,0
AG8A004669_119980_2024-07-29-0001.jpg,110202030.02.1.0001,54,324,4,382,0,0
AG8A004669_309920_2024-07-29-0001.jpg,110204013.01.1.0001,170,473,14,657,0,0
AG8A004669_333836_2024-07-29-0001.jpg,110202009.02.1.0001,79,411,9,499,0,0
AG8A005009_078080_2024-07-29-0002.jpg,180102001.02.1.0001,56,410,4,470,0,0
AG8A005009_691871_2024-07-28-0001.jpg,181101001.01.1.0001,80,396,17,493,0,0
AG8A005306_029025_2024-07-29-0029.jpg,091001032.02.1.0001,94,283,3,380,0,0
AG8A005306_036941_2024-07-29-0005.jpg,092501002.01.1.0001,119,305,9,433,0,0
AG8A005306_062834_2024-07-29-0015.jpg,091001003.03.1.0001,99,411,5,515,0,0
AG8A005306_133637_2024-07-29-0008.jpg,091001003.01.1.0001,108,402,13,523,0,0
AG8A005306_236226_2024-07-29-0011.jpg,090502001.01.1.0001,162,243,14,419,0,0
AG8A005306_240039_2024-07-29-0002.jpg,090501008.02.1.0001,102,347,11,460,0,0
AG8A005306_623586_2024-07-29-0003.jpg,091003008.03.1.0001,114,386,15,515,0,0
AG8A008553_126373_2024-07-29-0001.jpg,030105001.02.1.0001,208,344,3,555,0,0
AG8A008553_883897_2024-07-28-0001.jpg,030101010.01.1.0001,358,211,8,577,0,0
AG8A009202_009379_2024-07-29-0001.jpg,160601017.02.1.0001,151,436,14,601,0,0
AG8A009202_069198_2024-07-29-0001.jpg,160801011.03.1.0001,197,376,20,593,0,0
AG8A009202_099951_2024-07-29-0001.jpg,160801026.01.1.0001,134,413,17,564,0,0
AG8A009202_138815_2024-07-29-0001.jpg,160601024.04.1.0001,206,371,32,609,1,0
AG8A009202_151135_2024-07-29-0001.jpg,160801011.01.1.0001,185,329,12,526,0,0
AG8A009202_153318_2024-07-29-0001.jpg,160601010.01.1.0001,156,402,12,570,0,0
AG8A009202_175001_2024-07-29-0001.jpg,160603004.01.1.0001,241,328,21,590,0,0
AG8A009202_212479_2024-07-29-0001.jpg,160601011.01.1.0001,206,462,25,693,0,0
AG8A009202_263439_2024-07-29-0001.jpg,160801008.03.1.0001,212,375,19,606,0,0
AG8A009202_354352_2024-07-29-0001.jpg,160601039.03.1.0001,236,282,28,546,0,0
AG8A009202_364916_2024-07-29-0001.jpg,160601040.03.1.0001,221,319,23,563,0,0
AG8A009202_428161_2024-07-29-0001.jpg,160601039.02.1.0001,220,286,30,536,0,0
AG8A009202_649836_2024-07-29-0001.jpg,160801012.01.1.0001,172,454,15,641,0,0
AG8A009202_730912_2024-07-29-0001.jpg,160602006.01.1.0001,227,208,17,452,0,0
AG8A009202_812784_2024-07-29-0001.jpg,160601048.02.1.0001,195,314,21,530,0,0
AG8A009202_860926_2024-07-29-0001.jpg,160802003.01.1.0001,166,335,15,516,0,0
AG8A009202_948492_2024-07-29-0001.jpg,160801015.02.1.0001,116,439,10,565,0,0
AG8A009371_009998_2024-07-29-0046.jpg,100301001.01.1.0001,125,436,9,570,0,0
AG8A009371_753596_2024-07-29-0029.jpg,100301012.02.1.0001,82,457,11,550,0,0
AG8A009371_756361_2024-07-29-0002.jpg,100301010.02.1.0001,127,299,14,440,0,0
AG8A009371_820118_2024-07-29-0004.jpg,100301030.01.1.0001,240,347,14,601,0,0
AG8A009371_944215_2024-07-29-0005.jpg,100301031.02.1.0001,266,344,22,632,0,0
AG8A009373_203002_2024-07-28-0001.jpg,091901004.01.1.0001,93,186,6,285,0,0
AG8A009373_997337_2024-07-28-0001.jpg,091901005.01.1.0001,73,163,6,242,0,0
AG8AC28766_002757_2024-07-29-0001.jpg,070301012.04.1.0001,122,367,26,515,0,0
AG8AC28766_036509_2024-07-29-0001.jpg,071101046.02.1.0001,127,309,16,452,0,0
AG8AC28766_045787_2024-07-29-0001.jpg,070801010.02.1.0001,148,354,14,516,0,0
AG8AC28766_059669_2024-07-29-0001.jpg,070401001.03.1.0001,129,344,13,486,0,0
AG8AC28766_070624_2024-07-28-0009.jpg,070401004.04.1.0001,153,371,16,540,0,0
AG8AC28766_147188_2024-07-29-0001.jpg,070401014.04.1.0001,83,418,12,513,0,0
AG8AC28766_221772_2024-07-29-0001.jpg,070302002.04.1.0001,180,276,20,476,0,0
AG8AC28766_232538_2024-07-29-0001.jpg,070401010.01.1.0001,106,390,13,509,0,0
AG8AC28766_238724_2024-07-29-0001.jpg,070401015.04.1.0001,88,456,9,553,0,0
AG8AC28766_308326_2024-07-29-0001.jpg,071101011.05.1.0001,138,389,13,540,0,0
AG8AC28766_427605_2024-07-29-0001.jpg,070301004.03.1.0001,161,300,17,478,0,0
AG8AC28766_465596_2024-07-29-0001.jpg,071101011.01.1.0001,162,403,23,588,0,0
AG8AC28766_492291_2024-07-28-0005.jpg,070401012.02.1.0001,91,432,16,539,1,0
AG8AC28766_501538_2024-07-28-0001.jpg,070401012.05.1.0001,110,433,15,558,0,0
AG8AC28766_533393_2024-07-28-0003.jpg,070401012.03.1.0001,120,407,18,545,0,0
AG8AC28766_535416_2024-07-29-0001.jpg,070401016.03.1.0001,135,401,14,550,0,0
AG8AC28766_666449_2024-07-29-0004.jpg,070301010.01.1.0001,184,282,18,484,0,0
AG8AC28766_701480_2024-07-29-0001.jpg,070402001.05.1.0001,97,460,14,571,0,0
AG8AC28766_817413_2024-07-29-0001.jpg,070401002.02.1.0001,114,349,15,478,0,0
AG8ACO4551_114240_2024-07-29-0008.jpg,070908009.03.1.0001,139,356,16,511,0,0
AG8ACO4551_116854_2024-07-29-0006.jpg,070908028.02.1.0001,132,304,17,453,0,0
AG8ACO4551_122501_2024-07-29-0015.jpg,070904039.04.1.0001,104,385,16,505,0,0
AG8ACO4551_131103_2024-07-29-0009.jpg,070908014.02.1.0001,89,399,11,499,0,0
AG8ACO4551_148378_2024-07-29-0029.jpg,070905001.01.1.0001,72,397,9,478,1,0
AG8ACO4551_163322_2024-07-29-0026.jpg,070901006.02.1.0001,87,263,6,356,0,0
AG8ACO4551_205128_2024-07-29-0005.jpg,070904025.04.1.0001,129,358,19,506,0,0
AG8ACO4551_240629_2024-07-29-0002.jpg,070906019.02.1.0001,47,372,4,423,0,0
AG8ACO4551_303439_2024-07-28-0001.jpg,070906007.08.1.0001,28,426,4,458,0,0
AG8ACO4551_336067_2024-07-29-0011.jpg,071301012.07.1.0001,54,218,3,275,0,0
AG8ACO4551_411881_2024-07-29-0001.jpg,071201021.03.1.0001,115,352,15,482,0,0
AG8ACO4551_429672_2024-07-29-0011.jpg,070907002.03.1.0001,124,346,16,486,0,0
AG8ACO4551_459301_2024-07-29-0047.jpg,070905006.05.1.0001,118,342,8,468,0,0
AG8ACO4551_462237_2024-07-29-0005.jpg,071201007.07.1.0001,90,422,11,523,0,0
AG8ACO4551_488850_2024-07-29-0001.jpg,071201007.05.1.0001,70,463,10,543,0,0
AG8ACO4551_573931_2024-07-29-0004.jpg,070908016.04.1.0001,122,391,12,525,0,0
AG8ACO4551_574311_2024-07-29-0003.jpg,070904030.01.1.0001,142,330,19,491,0,0
AG8ACO4551_695149_2024-07-29-0006.jpg,070601004.02.1.0001,109,258,10,377,0,0
AG8ACO4551_709088_2024-07-29-0003.jpg,070906012.01.1.0001,13,307,3,323,0,0
AG8ACO4551_718045_2024-07-29-0001.jpg,070906023.04.1.0001,59,388,7,454,0,0
AG8ACO4551_718595_2024-07-29-0001.jpg,070907004.01.1.0001,155,396,23,574,0,0
AG8ACO4551_720000_2024-07-29-0002.jpg,070905003.01.1.0001,98,244,14,356,0,0
AG8ACO4551_724869_2024-07-28-0001.jpg,070906019.08.1.0001,49,385,1,435,0,0
AG8ACO4551_743001_2024-07-28-0001.jpg,070906019.07.1.0001,38,373,11,422,0,0
AG8ACO4551_771687_2024-07-28-0001.jpg,070906017.02.1.0001,34,333,5,372,0,0
AG8ACO4551_792275_2024-07-29-0025.jpg,070702001.01.1.0001,106,386,13,505,0,0
AG8ACO4551_806352_2024-07-29-0004.jpg,070601008.01.1.0001,108,212,9,329,0,0
AG8ACO4551_851709_2024-07-29-0001.jpg,071201002.04.1.0001,118,404,21,543,0,0
AG8ACO4551_911919_2024-07-29-0011.jpg,070908014.04.1.0001,94,384,15,493,0,0
AG8ACO4551_923778_2024-07-29-0009.jpg,070904018.03.1.0001,179,409,20,608,0,0
AG8ACO4551_974485_2024-07-29-0003.jpg,071101010.03.1.0001,118,396,14,528,0,0
AG8ACO4551_975628_2024-07-29-0021.jpg,070908022.03.1.0001,126,391,17,534,0,0
AG8ACO4551_975644_2024-07-29-0001.jpg,070906005.05.1.0001,52,405,18,475,0,0
AG8ACO4551_985107_2024-07-29-0023.jpg,070905007.01.1.0001,84,336,10,430,0,0
